````````````````````````````````````````````````````````````````````````````````````````````````````````````````````````````````````
``~~~~~~~~~~~~~~~~~~~~~~~~~~~~~~~~~~~~~~~~~~~~~~~~~~~~~~~~~~~~~~~~~~~~~~~~~~~~~~~~~~~~~~~~~~~~~~~~~~~~````~~~~~~~~~~~~`~~~~~~~~~~~``
`~BBBBBBBBBBBBBBBBBBBBBBBBBBBBBBBBBBBBBBBBBBBBBBBBBBBBBBBBBBBBBBBBBBBBBBBBBBBBBBBBBBBBBBBBBBBBBBBBBBBB~``~BBBBBBBBBBBB~BBBBBBBBBBB~`
`~BIGTGGGGTTTGFFFFFFFFTTGGGGGTTGTTTGTGTGTFIIIIIGTGIGGFFFGGGGGLGTGTGGGFFFFFFFFFGTGTFFFFFFFFFFIIIIITGGTGB~~BBGGGTGGGGGB~`~BGGGGGGBTB~`
`~BIITGTTGTGGGGFFFGFFGGFFFFFGGGGTGGGGTTTTFIIIIIIIIIIGGLLLLGTLLLGGGGTTTFFFFFFFFGGTGFFFFFFFFFFIIIIIGGGGGGBBTGGGGGGGGBB~```~BGTGBB~BB~`
`~BIICCCTGGTTGTGGTTGGTTFFFFFGGTGGTGGGTTFFFFFFIIIIIIIIL~~~LGTL~LLTGGGTGTGFFFFFFFTGGFFFFFFFFFFIIIIIGTGGGLLGLGTTTGTGTB~```~BBGTFB~~~~``
`~BGTCCIITGGGGGGGGGGGGTFFFFFGGGTGGGGGTGFFFFFFFIIIIIIIL~``~LL~`~LTGGTGFGGGFFFFFGGGTFFFFFFFFFFTGIIIGGGTLL~~LLGFGTGFB~`~~~BBGFTFGBBBB~`
`~BGICIIIGGTGTMGGGGTTTGFFFFFFGTGGTTTGTGTFFFFFFIIIIIIIL~``~LFL~LLTTTTTFGGTTTFFTFGFGGFFFFFFFFFGTGGGGGTLL~``~LFFFFFFB~~BBBFGFFCFGGTGB~`
`~BGGIIIIIGGTHGPPPGGGGGGGGGFGGGGTTGGGGTTFFFFFFFIIIIIIL~``~LTLLGGTGGGTFFGTGTGGFFGFFGGFFFFFFFFGGGGGTTLL~````~LFFFFFGBBGTFFFFCCFFGGGB~`
`~BGTIIIIIGTGTGGGGPGGGGGPPGFGGGGGTGGTGGGFFFFFFFIIIIGIGL~~LLFGFFFFGGGFFFGGGTGFFFFFGFFFFFFTFFFFGTGGGLL~`````~LFFFFFFTTGFFFFFFCFFFGGB~`
`~BGGGIIITGLGTGGTGGGTGTGGPGGGPPPGGGGGGPGGGGFFFFGTTFFFGLLLFGFFFFFFGGTFFFFGTGGFFFFFTTGFFFFFFFFGTGTTLL~````~~LLFFFFFGGGTFFFFFFFFFFFGB~`
`~BTGGIIIGLLLGTGTGLLLGTGGGGGPPPPPPPPPPPPPGTGTTGGTGFFFFFFFFFFFFFFFTTTFFFFGTGTGTFFFTGGGFGFFFFTGGTGLL~````~LLFFFFFFFFTTTTGTFFFFFFFFFB~`
`~BFFFIIIIL~LGGGTL~~LLGTTGTGGGGGPGGGGGPPPGGGLLLLLLTGFFFFFFFFFFFGTGGGGFFGGGGGGGGGFGGIIIIITTGGGTGTL~`````~LGFFFFFFGGGTTGGGFFFFFFFFFB~`
`~BFGIIIIL~`~LGGTL~`~LGLLLLGGTTGGGTGTGGGPGGLL~~~~LLGFIFFFFTGTFFTGTGGGGGGGGTGGGTGTGIIIIIIIGGGGLLL~```````~LGGFFFFFFGLLLLLLLGTFFFTTB~`
`~BGGIIIIL~`~LGGGL~~LLL~~~LLGGGGGGGTGTTGPGTL~````~LLIIFFFGGGGGLTTGGTGGTGGTTTGTTGTGIIIIIIIIGTTL~~`````````~LFFFFFFFL~~~~~~~LTGFGTGB~`
`~BGGIIITL~`~LGPGGLLTGL~``~LGGGLLLGGGGGGGGGGL~````~LIIFFFGGTGLLLTGGTGGTTGGGGGGGGTGGGIIIIIGTGL~```````````~LFFFFFFFL~`````~LGTGTTGB~`
`~BFFFIGTL~~LLGGGGTTGGTL~~LLGGTL~~LTTGGTGGFGLL~`~~LLIIFTGGTGTL~LGGGTTTGGGTFFFFGGTGTGIIIIIGGGL~```````````~LFGFFFFFGL~```~LGTGGGTGB~`
`~BGBBBBGGLLTGTGGTTGGGTLLLGGGTGGL~LTGTGTGGFGILL~LLIIIIGGTTTGL~`~LGTGGGTIIIIFFFFGTTGGGGIGTGTTTL~``````````~LFFFFTFGGLL~``~LTGTTTGTB~`
`~BB~~~BGFFFFFGGGGGTGGTGGTGTGTGGLLTGGTGTGGFGTL~LLIIGIIGIGGGGL~`~LLGTGGGIIIIIFFGGTTTGGTTTTGGGGL~`````````~LLGFFFFGTTTL~``~LTGGTGGGB~`
`~B~```~BFFFFFGPPGGTTGTTTTGGGLLLGFGGTGGTGGFFL~`~LIGIIIIITGGTL~``~LGGTGTGIIIIIFGTTGTTGTGGGGGGTL~`````~~~~LLGFGGGLLLLL~```~LGGGGGTTB~`
``~````~BFFFFFGPPGGTGGTGGTTGL~~LFFFLLLLGGGGFL~`~LIIIIIIIGGGGGL~~LLTTGGTIIIIIGFTTGTTGGTTGGGTGTL~````~LLLLGLLLFFLL~~~~`````~LLTGGGTB~`
`~B~```~BFFGFFGPPGGTTGTGGGGGL~`~LFGL~~LGGGGFGL~LLIIIIIIITGGGGLLLGGGGGGGGFFFFFFFGGGTGGGGGTGTGL~`````~LGGGL~~LFGL~````~`````~~LLLGGB~`
`~B~```~BGTFFFGPPPGGGGGGPPGGL~`~LFL~``~LTGDGGLLGGIIIIIITTGGGGGGGGGGGGGGGFFFFFTGTGTGGTGGTTGTGL~````~LLGGL~``~LTGL~``~L~``````~~LGGB~`
`~BB~~~BBGFFFFGGGGGGGGPPPPPGL~~LLFL~``~LGGGTFFGTGIIIIIGTGGGGGGGGGGGGGGGGGGFFGGGGGTTGGGGGGGGGL~```~LLGTGL~``~LFTLL~~LLL~```````~LGB~`
`~BGBBBGGGFFFFFFFGGTTGGPPPPGGLLGGFL~~~LLGTTTLFGTTIIGIIGTGGGGGGGGGGGGGGGGGGTGTTGGGTGGGGGGGGTTL~``~LLTTGGGL~~LLFGGFLLTL~`~~~~~``~LGB~`
``~~BTTTGTGFFGFLLLLLGTGGGPPGGGGTGFGLLLGGTGGLLGTGTIITGGTTTGGGGGGGGGGGGGGGTGGGTGTGGGGGGGGGGGGGGL~~LLGTGGTGLLLGGFFFFGTGGL~LLLLL~~LLTB~`
````~BGTGGGGGGGL~~~LGTTTGPPGGTTTGFGTGGGGGGLL~LLLLLLGGGTGTGGGGGGGGGGGGGGGGGGTGTGGGGGGGGGGGGGGGLLLGGGGGGGTGGTTFFFFFTGGGLLTGFFFLLGGTB~`
````~BGTGGGGGTL~`~`~LGGGGGGGGGGGGGGGGPPPPGL~`~~~~~LLGGGGGGGGGGGGGGGGGGGGLLLLGGGGGGGGGGGGGGGGGGGGGGGGGPGGGGGGGLLLLGGGGGGGGGGGGGGGGB~`
````~BGGTTGGTTL~~J~~LGGGLLLLLLLGGPPPPPPPPGGL~`````~LGGPPPGGGGGGGSGGGGGGGL~~LGGGGGGGGGGGGGGGGGGPPPPPPPPPPPPPGGL~~~LGGGGPPPPPPPPPGGB~`
```~BGTTGTGLLLGL~~`~LGGL~~~~~~~LGGGGGGGGGGGLL~`````~LGGGGGGGGGGGGGGGGGGL~``~LGGGGGGGGGGGGGGGGGGGGGGGGGPPGGGGL~``~LGGGGGGGGGGGPGGGB~`
```~BGFGTTGL~~LLL~~LLTGL~`````~LFFFFFFFGGTTTL~`````~LTTTGGGGGGGGGGGGGGGL~``~LTGGGGGGGGGGGGGGGGFFFFTTTGGGGTTGL~``~LGGTGTMFFGTGGGGGB~`
``~BBFFGTTL~``~LGLLGGGGL~`````~LGGGGGGGGGGGGGL~~~`~LLGGGGGGGGGGGGGGGGGGL~```~LGGGGGGGGGGGGGGGGFFFTGGGTGGGGGGL~```~LLLTGFFGTTTGGGGB~`
`~BGGGGTGTL~```~LGGGGGGGL~````~LGPPPPPPPPGGGGLLLL~LLGGPPPGGGGGGGGGGGGGGL~```~LGGGGGGGGSGGGGGGGFFFFTTGTTGGGTGTL~```~~LTTGGGGTGBBBGB~`
`~BGTGGTTTL~```~LGGGGGGGLL~```~LGGGPPPPPPPGGGGGGGLLGGGPGGGGGGGGGGGGGGGGL~````~LGGGGGGGGGGGGGGGFFFGTGGTTGGTGTGL~`````~LTGTLTGGB~~BB~`
`~BTTGGGGTGL~~~LLGGGTGGGTGL~``~LGTGPPPPPPPPGFFFFGGGTGGGGTGGGGGGGGGGGGGGL~````~LGGGGGGGGGGGGGGGFFFFTGGGTTGGTGGGL~````~LGGLLLGB~``~~``
`~BGTTGGGGGLLLLGGGGGGGGGGGLL~~LLGGGPPGGGGGGGGFFFFTCCCCCGTGGGGGGGGGLLLLLL~````~LGGGGGGGGGGGGGGGFFFFTGGGGTTTGGGGL~```~LTTGL~LTB~``````
`~BGGTGGGGGGGGGGGGGGGGTGGTTGLLGGGGPPGGTLTTGPGFFFGGTCCCTGTGGGGTGTFGL~~~~~````~LTGGGGGGGGGGGGGGGFFFGGGTTTTGFTFGTL~```~LGTL~`~LB~```~``
`~BGTIGGGGGGGGGGGGGGGGGTTTTGGGGTTGPPGGLLLGGGGFFFGGGGCTGGTGTTGGGGFL~`````````~LGGGGGGGGGGGGGGGGFFFTTTGGGGGFFFFFL~```~LTTL~`~LGB~~~B~`
`~BGGIGGGGGGGGGGGGGGGTTGGGTGDPGGGGPPGTL~LGTGGFFTGGGGTGTGGTGTTTGNFL~```~~~~~~LLFGGGGGGGGGGGGGGGLLLGTTTTTGTGFFFFL~````~LTGL~LLGBBBBB~`
`~BGTIGGGGGGGGGGGGGGGTTGGGTGGPPPGGGGGL~`~LGGGFTGTGTGTGGGTTGGGGGGFL~``~LLLLLLFGGGGGGGGGGGGGGLLL~~~LGTGTTGTFFFGFL~````~LFGLLFGFGGGGB~`
`~BTGIGGGGGGGGGGGGGGGTGGTGTTMGGGGTTGTL~~~LTGGGGGGGGGGGPGGGGPPPPGFL~~~LLFFFFFFFGGGTTTGTGFFFL~~~``~LGTGGGTTLLLLFL~```~LLFFFFFFFFGGGB~`
`~BBIIGGGGGGGGGGGGGGGGGGGGGGGPGGLLLGGGLLLGTGPGTGGPPPPPPPPPPPPPPGFGLLLGGTGFFFFFFFTGGGTFFFFFL~~~~~LLGGGGLLL~~~LFTL~~~LLGGFFFFFFFGGGB~`
`~B~BIGGGGGGGSGGGGGGGPPPPPPPPPGL~~~LGGTTGGTGGGGGGGPGGGGGGGGGGGGGGGTTGGTGFFFFFFFTTGGTGGGGGGGLLLLLGGGGGLL~~```~LGLLLLGGGFFFFFFFFGGGB~`
``~~BIGGGGGGGGGGGGGGGGGGGGGGGPGL~~~LGTTTGGGGGTGTTGPGGGGGGGGGGGGGGGGGFGTGFFFFFFFFTGGGGTGGGFFFFFGTTTTGGL~`````~LGGGGGTGGTFFFFFFFGPGB~`
`~BBTIGGGGGGGGGGGGGGGFFFFFFTGGGGLLLGGGGGGGGPGGTTGGPGGGGGGGGGGGGGGGFFFFFGFFFFFFFGGTTTGGGGFFFFFFFFFGGGGGL~```~LLGGGLLLLGGFFFFFFFGPGB~`
`~BGGTGGGGGGGGGGGGGGGGFFFFFGGGGGGGGGGGGGGGGPGTTGTGPGGGGGGGGGGGGGGGTFFFTGFFFFFFFTFGGGGGTFFFFFFFFFTTTGGGLL~~~LLGGTGL~~LLGTTFFFGTGPGB~`
`~BGGFGGGGGGGGGGGGGGGGTFFFTGGGGGGGGGGGGGGGGPGGTTGGPGGGGGGGGGGGGGGGGFFTGTTGFFFFFFFFFFGGFFFFFFFFFTTGGGTTGGLLLTGTFFL~``~LTTFFFFGTGGGB~`
`~BGFGGGGGGGGGGGGGGGGGGGFGTGGGGGGGGGGGGGGGGPPGGGTGPGGGGGGGGGGGGGGGGFFGGFTTFTFTGFFFFFFGTFFFFFFFFFFGGGGGLFFFFFFGFLL~```~LGIFFFFGLLGB~`
`~BGFFGGGGGGGGGGGGGGGPPGGGGGGGGGGGGGGGGGGGGPPPPGGGPGGGGGGGGGGGGGGGTFFFFFFFFFGGTFFFFFFGGFFFFFFFTFFFFFGLLLGFFFFFFL~````~LIIIIFFL~~LB~`
`~BFFFGGGGGGGGGGGGGGGPPPPPPPGGGGGGGGGGGGGGGPPPPPPPPGGGGGGGSGGGGGGGGFFFFFFGFGTGTTFFFFGGGTFFFTTFFFFFFFLL~LLFFFFFL~```~~LLIIIIIGL~~LG~`
`~BFFFFFGGGTTGGGGPPPPPPPPPPPGGGGGGGGGGGGGGGGGGPPPPPGGGGGGGGGGGGGGGFFFFFFGGGGTGTGGGGTTGGGGTFGGTGFFFFFL~~~LTFFFFL~~~~LLGIIIIIIIGLLGB~`
`~BFFFFFFTGTTTGTGPPPPPPPPPPPGGGGGGGSGGGGGGGFFGPPPPPGGGGGGGGGGGGGGGGFFFFFFGTTGTGGGTTTTTGTTGFGTTGGFFFFGLLLGGGFFFGLLLLFFGGIIIIIIIGGGB~`
`~BFFFFFFGGTTGGTGPPPDPPPPPPPGGGGGGGGGGGGGGGFFGPPPPPGGGGGGGGGGGGGGGGFFGGGGGGGGGGGGGGGTGTGTGTGTTTTGTGGGGTGTFFTFFTFFFFFFFIIIIIIIIGPGB~`
`~BFFFFFFGTFGTGTGPPPPPPPPPPPGGGGGGGGGGGGGGGFFGPGGGGGGGGGGGGGGGGGGGGGFGGGGGGGGGGGGGGGGGGTTGGTGTGTGTTGGGGGGFFFFGTTFFFFFFFTIIIIIIGGGB~`
`~BFFFFFFGFFFFGTGPPGPPPPPPPPGGGGGGGGGGGGGGGTGGPGFFFGGGGGGGGGGGGGGGGTTGGGGGGGGGGGGGGGTGGGTTGGGTTGGTGGGTTGTFFFFTTGLLLLLGFIIIIIFFGGGB~`
`~BGTTFFGGFFFFGGGPPGPDPPPPPPGGGGGGGGGGGGGGGGTGDGFFFGGGGGGGGGGGGGGGTGTGGGGGGGGGGGGGGGTTGGGGGTGGTGGGGTGTGFFFFFFFGGL~~~LTFIFFFFFFGGGB~`
`~BGTTGGTFFFFFFGGPPGPPPPGGGPGGGGGGGGGGGGGGGGTGGGFFFGGGGGGLLLLLLLLLLLLGGGGGGGGGGGGGGGTGGGGGGLLLGGGGGGGGGGGGGGGGGL~```~LTIFFFGBBBBGB~`
`~BFGGGTGFFFFFFFGPPGGGGGGTGGGGGGGGGGGGGGGGGGGGGTFFFFGTTTGL~~~~~~~~~~LGGGGGGGGGGGGGGGGFFGTGL~~~LGGGGGGGGGGGGGGGGL~```~LTGGFFGB~~BGB~`
`~BFGGGGFFLFFFFFGPPPPPPPGGGGGGGGGGGGGGGGGGGGGLLLLLLGGGGGL~``````````~LGGGGGGGGGGGGGGFFFTGGL~`~LTGGGGGGGGGGGGGGGGL~``~LGTGGFB~``~BB~`
`~BFFGGGGLLLGFFFGPPPPPPGGGGGLLLLLGGPPPPPPPPGLL~~~~LGGPPGL~``````````~LGGGGGGSGGGGGGGFFFGGGGL~~LTGGGGGGGGGGGGGGGGLL~`~LTTTTGB~```~B~`
`~BFTFGGLL~LLFFFGGGGGGGGGGGLL~~~~LGGGPGGGPPGL~````~LGGGGL~````~~~~~~LLGGGGGGGGGGGGGGFFFTTGGLLLGGGGGGGGGGGGGGGGGGGL~~~LGTTGGB~```~~``
`~BGFFFGL~~~LGFGTGGTTGTGGTGL~```~LGTGGGTGGGGGL~```~LTTHTL~```~LLLLLLGGGGGGGGGGGGGGGGFFFGGGGGGTGGGGGGGGGGGGGGGGGTGGLLLGGGGGTGB~~~BB~`
`~BGFFFFGLLLGTGGGGGGGGGLLLL~``~~LLGTGTGGTGTGGL~```~LGGTTL~``~LLGGGGTGGGGGGGGGGGGGGGGFFTTGTGGGGGTGGGGGGGGGGGGGGGGTTTTGGTGGGTGBBBBGB~`
`~BTFFGGTGTGGGGGGGTGGGLL~~~``~LLFFFGTGTGGGGGGFL~``~LGGGTGL~~LLGTGTGGGGGGGGGGGGGGGGGGFGGTGGGGGGTTGGGGGGGSGGGGGGGTGGGGLLLLGGGGTTGGGB~`
`~BTGTTTTTTGTGGTGGTGTTL~````~LFFFGGGTGGTGGGGFLL~``~LGGGGGLLLGGTGGGGGTGGGGGGGGGGGGGGGTGTGTGGTTGGGGGGGGGGGGGGGGGGTTGGTL~~LTGGGTGGGGB~`
`~BTTTGGGGGTGTTTTGGGTL~`````~LFFGFTTGGGTTGGFFL~``~LTGGFFGGGGGTTGGGGTGGGGGGGGGGGGGGGGGTTGTGGTGTGTGGGGGGGGGGGGGGGTGTGL~``~LIIGGBBBBB~`
`~BTGGGGLLLLGGGTTGGFFL~````~LGFGFFGTTGGGLLLLL~```~LTTFFFFGGTGGTGGGTTGGGGGLLLGGGGGGGGGGGTGTGTGGTGGGGGGGGGGGGGGGGGTGGL~``~LIIIB~~~~B~`
`~BGGGFLL~~LLGFGFFFFFFL~```~LGFFFFTGGGGGL~~~~````~LLLTFFFGGGGTGGTGTLLLLLL~~~LGGGTGTTGGGGTTGGGGGTGGGGGGGGGGGGGGGGLLL~````~LIFB~```~``
`~BFGFLL~``~LLFFFFFFFGL~````~LTFFFTGTTGL~`````````~~~LFFFTTGGGGIGTGL~~~~~``~LGGGGGGTGGGGTTTTTTTGGGGGGGGGGGGGGGGLL~~`````~LIFGB~`~B~`
`~BFFFL~````~LLFFFFFFTL~````~LFFFFTTGGGL~````~~~~~``~LFFGTTTGGIIGIGGL~~~~~~~LTTGGGGTGGGTGGGTTGGGGGGGGGGGGGGGGGGL~```~~``~LGGGB~~BG~`
`~BGFL~``````~LFFFFFFGL~````~LTFFFGGTTGGL~~~~LLLLL~~LLFFGGGGTIIIIIIGLLLLLLLLGTGFGGTTTGTGGTGTGTGTGGGGGGGGGGLLLLL~```~LL~~LLGGGB~~BB~`
`~BTFL~```````~LFFFFFFTL~```~LGFFGGTTGTGLLLLLGTGGGLLGGFGTTTTIIIIIIFFFFFTTGGGGGGFGGTTGGGTGGGLLLLLGTTGGGGPGGL~~~~``~~LLGLLIGIIB~``~B~`
`~BGL~````````~LGGTFFGGL~``~LLGGGGGGGFFFFFFGGGGGGTGGTTGTTGTTGGTGIIFFFFGGTTGTFFFFFFGGGGTGGGLL~~~LLGGGGTGPGL~`````~LLGTGGGIIIGB~``~B~`
`~BGL~```````~LTGGGTGTGGL~~LGLGGTGGGFFFFFFFFGGGGGTGTGTGGTTGGGTGTTGFFFTTGGGTFFGFFFFFGTGGGTGL~```~LGGGGGGPGL~````~LLTGGGGGIIIB~````~``
`~BL~````````~LGGTTGGTGGLLLGGLLTGGTGFFFFFFFFGGFFFTTTGTTGTTFFFFGGGFFFGGTTGGTGTFFFFFGTGLLLLL~`````~LGGGGGPGGL~``~LLGGGGGTTGIIB~```````
`~BG~~~~~~``~LLGGTGGTGTGGGGLL~LLGTTTFFFFFFFFFFFFFFFTGGTTTTFFFGTTGGGGGFGGTTTTGFFFFFFLL~~~~~``````~LGGTTGPGGL~`~LLGTTGTGTGTIIB~```````
`~BGLLLLLL~~LLGGGGGGLLLLGGGL~`~LTGGGGFFFFGTLGFFFFFFFFTGGTGFFFFTGGTGGGTGGGTGGGFFFFFL~~``````````~LGGGGGGPGGGL~LLGTGGTTGGTTGGB~````~``
`~BTTTGGTGLLTGGTGTGGL~~~LTGGL~LLGTGTGGFTFGLLGFGFFFFFFFFGGGGGFTTGLLLLLLLGGGGTGGFFGFL~``~~~~~````~LGTTTGPPGFGLLGGTGGGGGTGTGGTB~```~B~`
`~BTGGTGGGTGTTFFFGGL~``~LGGGLLTGFFFGGTTGFLL~LGGGFFFFFFFGGGGTGGGGL~~~~~LGGGGGGGFGGGL~~~LLLLL~~~~LLGGGTGPPGFFFGGGTGTGGGGTGGGGB~```~B~`
`~BGGGGTGGGTFFFFFGGL~``~LGTGTGFFFFFFTGGGGL~~LGGGTFFFFFFFTTGGTGGL~`````~LTGGGTGGGTGGLLLGGTGGLLLLFGTTGTMPPGFFFTTTGLTGGTGTGGGTGB~~~BB~`
`~BTGGTTTTTFFFFFFFGL~``~LGTTTFFFFFFFGTGGGGLLGGTTTGFFFFFFFFLLLGGL~`````~LTGGGTGGGGTTGTTTGTGGGGFFFGGGGGGGPGFFTTTGLLLGGGGGTGGGGBBBBGB~`
`~BTTTTGGTFFFFFFFGTL~``~LLTTGFFFFFFGGGGTGTTGTGGGGTFFFFFGTFL~~LTGL~```~LLGGGGFTGTTCCCCCGGGGTGTTGLLLLLGTGPGFFTGGGL~LGGTGTGGGGTTGGGGB~`
`~BTGTGTGTGGFFFFFGGL~```~LTGFFFFFFFFTTTGGGTGTGTGLTFFFFFFFFGL~LFGLL~~~LLGGTGFFFTTTGCCCGTTGGGTGGGL~~~LTGGPGFFTGTL~`~LTTTTTTGGGGGGGGB~`
`~BGGIITGTGGGGGFGTTGL~~~LLGGTFFFFFFFFGGGTGTGGGGGLGFFFFFFFFGLLGFGFFLLLTGGGGFFFFGGGTTCGGGGTTGGGGL~```~LGGPGFFTTGL~`~LGTGGTGTGGTFGGGB~`
`~BGGIIIIFFGTGTGTGTGLLLLGGTLTFTTFFFFFFTGGGTTTTTL~LFFFFFFFFFFFFFFFFFFFFTTGFFFFFGTTGGTTGTGTTGGGGL~```~LFGPGGGGGGL~`~LGGTGGGTGFFFGGGB~`
`~BGTIIIIFITGGGGTTGGTTTGTTLLLGGFFFFIIGLLLLLGGTTL~LFFFFFFFFFFFFFFFFFFFFGGGFFFFFTGTTGGTTGGGGTLTGL~```~LFGPPGGTTGGL~~LFGGGLLLGFFFGPGB~`
`~BGTIIIIIIGGGTTTTGGGGGTGGL~LGTFFGFIIIL~~~LLGGGGLLFFFFFFFFGGLLLLGFFFFTGGTFFTTTGGGGGGGGTGGGLLGTGL~`~LLFGPGGGGGTGLLLGFFFL~~~LFFFGPGB~`
`~BTTIIIIIITTGGTTGTGGTGGTL~`~LGGTTGIIL~```~LLTGGTFFFFFTFFGFTL~~LGFFFFFGGGTTTTFFGGTTGTGGFFLL~LGGLL~LLGFGPGTTGTTGGGGFFFFL~`~LFFFGPGB~`
`~BTGGIIIIIIGGGGTTGTTGGFFL~`~LTGTGGIIL~````~LTGTFFFFFFGTGFFL~``~LFGLLLLLGTGGGFFFTTFTGTTFFL~~LGTGGLLGFFGPGTTGGGTGFFFFFFGL~LLFFFGPGB~`
`~BGGGTIIIIIIIGTGGTGTTFFFGL~LLTTGTFIIIL~~~~LLGGGGTFFFFTGFFLL~``~LFGL~~~LGGTFTFFFFFFFTTGTGTL~LTGGGGGTGFGPGGGGTTTTFFFFFFGLLTGFFHGPGB~`
`~BIIIGGFFIIIIIIGGTGGGGGTGLLGLLLTFFIIGLLLLLTGGTIIIIFFFFGFLL~``~LLFL~```~LTFFFFFFFFFFFGTGTGLLGTTTGGTGGGGPGTTGGGGGTTFFFFFFGTFFFFGPGB~`
`~BIIITGFFIIIIIITTGTGGGGGTFFL~~LLTFFGFFFFFFFTGGIIIIFFTFFLL~``~LLGFL~```~LGFFFFFFFFFFTGGTGGGGGGTGTGGTGGPPGGGGPPPGGGGFFFFTTGFFFFGPGB~`
`~BIIIGGGFIIFIIGGLLLGTGFFGFL~``~LGFTGGFFFFFFFFIIIIIIIITGL~``~LLGGFGL~~~LLGFFFFFFFFFGGGTGTGTTTGGGTGTTGGPPPPPPPPPPPPGGGGGGGGGFFFGPGB~`
`~BIIIGGTFIFFIIGL~~~LTFFFFFL~`~LLGFGGGTFFFFFFFIIIIIIIIIL~````~LLFTGLLLLGGFFFFFFFFGFFFGGGGTTTLLGGTTGGTGGGGGGGGGGGGGGGGGGPPGGFFFGPGB~`
`~BIIIGGTGGIIFFFL~`~LTFFGGLFL~LLGGGTGGTGFFFFFFFIIIIIIIGL~`````~LFFFFFFFFFFFFFFFFFFFFGTGTGLLL~~LTGGGGTGTFFFFFFGLLLLLLLGGPPGTIIFGPGB~`
`~BIIIGGTGIIIFFL~``~LTGGGLLLLLGTGGTTGIIGGTTFFTFGLLLLGITL~``````~LFFFFFFFFFFFFFFFFFFFFGTGL~~~`~LTGGGTGTGGFFFFFGL~~~~~LGGPPGGIIIGPGB~`
`~BIIITTTIIIIGFL~``~LGGGLL~LTGGGGTGTGTGGTGGFTGTLL~~~LTTL~``````~LFFFFFGTFFFFFFFFFFFFTGTGL~```~LTGTGGGGGGFFFFFL~`````~LGPPPGIIIGPGB~`
`~BIIIIIIIIIIGGGL~~LLGGLL~`~LGTTTGTTTGGGGTGGTGTL~``~LTLL~`~~~~~~LFTFFTFFFFFFFFGFFFFFTGTTL~``~LLTGTGGGGGGFFFFFL~`````~LGGGPGIIIGPGB~`
`~BIIIIIIIIIGGGGLLLGGGGL~``~LTTTGLLLLLGGGGTGGGTGL~~LLGL~`~LLLLLLGTTTGTGFGGGFFGGGFFFFFGGGGL~~LLGGGGTGGGGTTGFFGL~`````~LITGPGIIIGPGB~`
`~BIIIIIIGLLLLLGGFFFGGL~``~LGTGGGL~~~~LLLGGGGTGGLLLGGGGL~LLFFFFTGTTGGGGGGGGGTGFFFFFFFGGGGLLLGGGGGGGGGTTTGTGGFL~````~LLIGGPGIIIGPGB~`
`~BIIIIIGGL~~~LTFFFFFFL~``~LGGGGL~````~~LGTTTTGGGTGGTGGLLFGFGFFFTGGGGTGGGTTGGGGGFFFFFGGGGGGGGGGGGGGGGGGTTTGFFL~```~LTGGGGPGIIGGPGB~`
`~BGIFFIFL~```~LFFFFGGGL~~LLGTGTL~``````~LGTTTGTTTGGGGGGTFFFFFFGGGTTGTGTGGTGGGGTGFFFFGGGGGGGGGGGGGGGTGGGGTLLLFL~``~LGGGTGPGIIGPPGB~`
`~BIGFFFFL~```~LGIIIGGGLLLGGTTGGGL~`````~LGGGTGGTGGGLLLLLGFGTFTTGGGGGTTTGGGTTGTFTFFFFGGGGGGGGGGGGGGGGGLLLL~~LFLL~~LLFGTGGPGGGGPPGB~`
`~BFFFFFTL~```~LIIIITTGGGGGTTGGGGLL~```~LGTFTTTGGGGGL~~~~LFGGTTGTGFTGFFGGGTGGGTFFTFFFGGGGGGGGGGGGGGGGLL~~~``~LFGLLTGFFFGGPGTTGPPGB~`
`~BTBBBBGL~``~LLIIIITTTIIIIIGTTGGGFL~``~LGGFGTGGGGGL~```~LLGTTGTGFFFFFFFFGTTGFFFFFGFFGGGGGGGGGGGGGGGLL~`````~LTTGFFFLFFFGGGGTGPPGB~`
`~BB~~~BTGL~~LLGIIIIGIIIIIIIIIIIGGFLL~~LLFFFFFGGGTLL~````~LTGGGFFFFFFFFGFFGGTTFFFFTFFGGGGGGGGGGGGGGGL~``````~LGGGGGGLGGGGGGGGGPPGB~`
`~B~```~BGLLLGGTFFFIIIIIIIIIIIIIIGFFGLLTGGFFFFFFGLL~``````~LGGGGFFFFFFFGGGGFGFFFFFFFFGGGGGGGSGGGGGGL~```````~LGGGLLL~LLLGGGGPPPPGB~`
``~````~BGGLGTGFFFIIIIIIIIIIIIIIIGFFFGTFFFFGTFTTGL~```````~LTTGTGFFFFFFGTFFFFFGFFFFFFGGGGGGGGGGGGGGL~``````~LLGGGL~~`~~~LGGGGPPPGB~`
`~B~```~BGLLLGFFFFFIIIIIIIIIIIIIITFFFFGGGGTGGTGTL~````````~LIIIIIIIIFFGFGTGFFFFFGFFGGGGGGGGGGGGGGGGGL~~```~LLGFFL~`````~LTGLGGGPGB~`
`~BB~~~BBGL~LGTFFFFIIIIIIIIIIIIIIGGBBBBBGGGGTGIIL~```````~LLIIIIIIIIITGTTGGFFFFTGTGLTGGGGGGGGGGGGGGGLLL~~~LLGGGFL~````~~LTGLLGGPGB~`
`~BGBBBGGL~`~LGGFFFFIIIIIIIIIIIITTGB~~~BBTGTGGIIGL~`````~LLGIIIIIIIIITGGGTFFFFGGTGGLLGGGGGGGGGGGGGGGGTTLLLFGTGGGL~``~~LLGLL~LGGPGB~`
`~BGGTGGGL~`~LGGFFFFIIIIIIIIIIIITGB~```~BTTGGGIIILL~~~~~LLGGIIIIIIIIGGTGTGFFFFFGGGL~LGGGGGGGGGGGGGGGGTGGFFFFFTGTGL~~LLGLL~~`~LGPGB~`
`~BGTGGGTL~`~LGGFFFFGIIIIIIIIIIGGGB~````~BGGGTGTGGGLLLLLIGIIIIIIIIIIGGGTGGFFFFGGGTL~~LGGGGGGGGGGGGGGGGGTGFFFFGGTGLLLTLL~~```~LGPGB~`
`~BGGGGGTL~`~LGGGFFFTIIIIIGTGGTGTTB~````~BBTGGGGGGGTGGGTIIIIIITGLLLLLLLLGGFFFFTGFGL~~LGGGGGGGGGGGGGGGGGGTGGFTTTTGTGGL~~`````~LGPGB~`
`~BTGTGGGL~`~LGGGTFGGIIITGTGGGTGGTB~`````~BGTGGGTGGGGTGTIIIIIFFTL~~~~~~LLGFFFFFFFGL~~LFFFGGGTGFFFFFTGGGTTTGGTGGGFGGTL~``````~LGPGB~`
`~BGGTTGTL~``~LTGGGGTGIFFGTGTGTGGGB~``````~BGGGTGTTTTGGTGGGIFFGL~``````~LLGFFFFFFFL~`~LFFFTGGGFFFFFFTTTTGGTGGGTFFFGGL~~`````~LGPGB~`
`~BTTGGGGL~``~LTGTTTGGGTGGGTGGGTTTB~``````~BTGTTGTTGGTGTTGTFFGGL~```````~LFFFFFFFFL~`~LFFFGGTFFFFFFFFGGTGGTGGGGFFFFGTLL~~```~LGPGB~`
`~BGTGTTTL~``~LGGGTGGGGGGGGTTTTGGGTB~````~BTGTGGGGGGTGTGGGGFFFFGL~~~~~~~LLFFFFFFFFL~`~LFFFFGGTTGFFFFGGGGGGGGGGGGFFIIGTGLL~``~LGPGB~`
`~BGGTGTL~```~LTGTGTGTTTGGGGTGGGGGGB~```~~BGTGTGGGGGGGGGTGGGFFFGLLLLLLLLTGFFFFFFFL~``~LFFFFTTGTTGTTTGGGGGGGGGTGGIIIIIGGGGL~~LLGPGB~`
`~BGGGTTL~```~LGGGTGGGTTGTFGFFGFGTGTB~`~BBGTTGTIIGTGGGTGTGTFFFFFTTGGFFFTTTTGFGFFFL~`~LLFFFFFFFTTGTGTGGTGGTGGIIIIIIIIIGGGGLLLGGGPGB~`
`~BGGGFTL~```~LGGGTGTTGGGFFFFFFFGGGTBB~~BGTGGTGIIITTGTGGGTFFFFLFFTTTGFTGTGTTGGGFFL~~LLTFFFFFFFGTTGTGGTGGIIIIIIIIIIIIIIIIGGGTGGGPGB~`
`~BGGTFGGL~~~~LGGBBBBGGGFFFFFFFFTTGGGB~`~BBGTGGITGLLLLLGGTFFGLLLGTTGFFGGGGGGGGGTFGLLTGGFFFFFFTGGGTGGGTGGIIIIIIIIIIIIIIIIGFGFFGPPGB~`
`~BGGGGGGLLLLLGGB~~~BBGTGFFFFFFFTGGTB~```~BGGTGGGGL~~~LLGGGGLL~LGGTGFFFTTGGTGTFFFFFFFGFFFFFFFGTGGLLLLGTIIIIIIIIIIIIIIILIGFFFFGPPGB~`
`~BTGGGGTGGGGTGGB~``~BGTTGFFFFFGGTTFB~````~BTTTTTL~```~LLTTGL~`~LGGGFFFFFGFTGGFBBBBBGGGFFFFFTGTGLL~~LGTIIIIIIIIIIIIIIGLLGFFFFMPPGB~`
`~BGTGTGCCCTGGGGB~~``~BBBTGFFTTGGTFFB~````~BGGTTGL~````~LTTGGL~~LTGFFFFFTFFGGFBB~~~BTTGFFFFGGGGTL~``~LTTIIIBIIIIIIIIIL~LLFFFFCPGGB~`
`~BGTTGTTTGGTGGTGBB~``~~BBTGGGTGTFFGFB~```~BFGGGTGL~````~LGGGLLLGGTFFFFGGTGFFBB~```~BGBBBGGGGTGGGL~`~LGTGGBBGIIBBBBBGL~~LFFFCCPGGB~`
`~BBBBBGGGGGTGGTGGFB~```~BGGGGGGGGBFFB~```~BFFGGTGLL~```~LGGGTGGGBBBGGGGGGFFBB~````~BTB~~BBBTGGGGLL~LLGGGBB~BBB~~~~BBL~LLFFCCCPGGB~`
``~~~~BGTGGTGTGTTGFB~````~BTGGGGGBBBFB~```~BBFFGGGGTL~~~LLTTGGGTGB~~BTGGGFFFB~`````~BB~``~~BTGGGGGTLLGTGTB~`~~~````~BGLLGFFFGGGJGB~`
``````~BGTTGTGGGGFFFB~```~BTGTGGTB~BFB~````~BFFFTGTGGLGLGGTTGGGGB~`~BTTTTGTB~```````~~`````~BGTGGTGTGTGGGGB~````````~BGGGFTFGGGGGB~`
``````~BBBBBBBBBBBBBBB~`~BBBBBBBB~`~BB~`````~BBBBBBBBBBBBBBBBBBBB~`~BBBBBBBB~``````````````~BBBBBBBBBBBBBBB~`````````~BBBBBBBBBBBB~`
```````~~~~~~~~~~~~~~~```~~~~~~~~```~~```````~~~~~~~~~~~~~~~~~~~~```~~~~~~~~````````````````~~~~~~~~~~~~~~~```````````~~~~~~~~~~~~``
````````````````````````````````````````````````````````````````````````````````````````````````````````````````````````````````````
