~~~~~~~~~~~~~~~~~~~~~~~~~~~~~~~~~~~~~~~~~~~~~~~~~~~~~~~~~~~~~~~~~~~~~~~~~~~~~~~~~~~~~~~~~~~~~~~~~~~~~~~~~~~~~~~~~~~~~~~~~~~~~~~~~~~~
~~~~~~~~~~~~~~~~~~~~~~~~~~~~~~~~~~~~~~~~~~~~~~~~~~~~~~~~~~~~~~~~~~~~~~~~~~~~~~~~~~~~~~~~~~~~~~~~~~~~~~~~~~~~~~~~~~~~~~~~~~~~~~~~~~~~
~~BBBBBBPPPPJPPPPBBBBBBBBBBBBBBBBBBBBBBBBBBBBBBBBBBBBBBBBBBBBBBBBBBBBBBBBBBBBBBBBBBBBBBBBBBB~~~~BB~~~~BBBBBBBBBBBBBBBBBBBBBBBBBBBB~~
~~BCCCFFPPPPPPPPPMGGGGGGGGGGGGGGGGGGTGTTFFFFIIIGGGGGGGGFGTGGGGGGGTGGGGTGGGGGGGGGGGGFFGGGLLLB~~~BGB~``~BGGGGGIIIIIGTGGGGGGGGGGGGGGB~~
~~BCCFFFPPP~LGPPPGGGGGTGGGGGGGGTTGGGGGGGFFFIIIIGGGTGGGFFFGGTGGGGGGGGGGGGGGTGGGGGGGGFFTGL~~~LBBBGB~```~BTGGFFFFFGIIGGFTGGTGGGGGGGGB~~
~~BCGFFFPPP~~LPPPGGGGGGGGIIIIGGGTGGGGGGGFFFGIGLLLGGFGFFFFFGTGTGGGGGGGTGTGGGGGFGTFGGFTTGL~`~LGGGGTB~~~BGGGGTGTGGGIIGFFFGTGGTGGGGGGB~~
~~BGGLFFPPP~`~PPPGGGGGGGFIIIIGGGGGTGGGGGGFGGGL~~~LFFFFFFFGGGGGGGGGGTGGGGGGGGFFFFFFFFFGGL~`~LGGGGGTBBBGGGGGGGIIGGIIGGFFGGTTGGGGTGGB~~
~~BTL~LFPPP~~~PPPGGGTGTFFIIIIGGTGGTTGGGGGGGTGL~~~LGFFFFGGGGTGGGGGGGGGGFGGTFFFFFFFFFFFGGL~~LGGGGGGGGGGGGGGGGGIGIIIGFFFFFTTGGGGGGTGB~~
~~BL~~~LPPPLLLPPPGGGGTTFFIIIIITGGGGTTGGGGGTGGGLLLGGFFFFGGGTTTGGTGGGGGGFGGTGFFFFFFFFFFFTL~~LGTGTGGGGGGTFFFFFFIIIGGGGGFFGGGGGTGGGGGB~~
~~BFLLLGPPPGGTPPPTGGGGTFFIIIIITGGGGLTGGTGTTGTGTTGGFFFFLLGGFFTGGGGGGGGGLGGGTGGFFFFFFFFTL~`~LFGGGTGGTGTGFFFFFFIIIIGGGTFGGGGGGLLLLGGB~~
~~BFFGGTPPPGGGPPPGGGGTGFFFIFFFFGTGL~LGGGGGGGGGGGTGFFFL~~LLFGGTGGGGGGGL~LLGGTTGFFFFFFLL~``~LFFGGGGTTGGFFFFFFIIIIIGGGTFFFGGGL~~~~LTB~~
~~BFFFTGPPPGGGPPPGTGGGGGFGGFFFGGGL~~LGGGGGGGGGTGGGFFL~``~~LGGGGGGGGGL~`~~LGGGGFFFFFL~~``~LFFFGGGGGGGGFFFFFFFLLLIGGGGGGGGGL~````~LB~~
~~BFFFGTPPPGGTPPPPGGTGTGGGGLLLGGGGL~LGGGTGGGGTGIIIIFL~````~LGTGTTGGGTL~``~LTGGFTFFL~``~~LFFFFFGFFGTGGGGFFFFL~~~LLGGTTGGTGL~````~LB~~
~~BFFGGGPPPGFFPPPPPTGGGGGFL~~~LGFTGLTGGGGGGGGGTIIIIFL~````~LGGGGGGGGTL~```~LGGGGGGGL~~LLGGFGTGGFGGGGGTGFFFL~```~~LTTGFGGGGL~~~~LGB~~
~~BGTGGGPPPGFFPPPPPTGGGTTFL~`~LTFFFFGGGGTGGGGTGIIIGGL~````~LTGGGGFFFGTL~``~LGGGGGGGGLLTTTGTTTGTFGTGGTGGGGGL~`````~LTFFFTGTGLLLLGGB~~
~~BGGGGGPPPTFFFPPPPGGGTGGFFL~LTGFFFFGTGGLLTGGGGIIIIGGL~~~~LGGGTGGFTGGFGL~~LGGGGGGGTGGTGTTGGGGTGTGGGGGGGGGGL~`````~LGGFFFGTGGGTGTTB~~
~~BGGGGFPPPGGGTTPPPGLLGFFFFFLGGGFFFFFGGL~~LGTTGGTTTGGGLLLLGTGGGGGTTGGTGGLLGGGGGTGGGTGGFFTGTGGGGGGGGGGGGLTGGL~```~LGFFFFFGGGGGFGFGB~~
~~BBTGGFPPPTGGGGPPPP~~LGFGFFGGFGFFFFLLTGLLGGGGGGFGTGGGGGGGGFGTGGGGFGGTGGGGGGGGGGGGGGGGFFFGGGGGGGTGGGGGL~LGGGL~~~LGGFFFFFGGGTFFFFGB~~
~~~~BBFFPPPGGGGGPPPPP~LGGGGGTTFTFFGL~~LTGGGTGGGFFGGGGGGFGTFFFFGFFFFFTGGTGFFGGGTGGGTGGTFFFGGGGGGGGGGGTL~`~LGGTLLLGGTFFFFFFGFFFFFFFB~~
~~~`~~BFPPPTGTGGPPPPPLGGGGGGGGTGTTGGLLGGGGGGGGFFFFFFGGGFFFFFFFTGFFFFFGGGGGGGGTTGGFTGGGFFFGGGGGGGGTTTL~``~LTGGGGGGGGGGGFFGFFFFFFFFB~~
~~~``~BFPPPGGGGGGPPPPGGTGGGGGGTGGTGFGGGGGGGGGFFFFFFFFGFFFFFFFFTGFFFFGGGTGGGGGTTFFFGGGGTFGGGTIIIGGGGGL~```~LGGGGTGGGTGGFFFFFFFFFFFB~~
~~~``~BFPPPGGGGTGGPPPGGTGGGTGGGGGFFFFGGGGGGGGTFGFFFFGGGFFFFFFFGTGFFFFFGGGGGGGGGGFGGGGGGTGGGGIIIIGTGTL~````~LGGGGGTTGGGFFGGTFFFFFCB~~
~~~~~BFFPPPGGTTGTGPPPGGGGGGGGGGGGFFFFTGGGGLGGGGFFFFFFGTGFFFFFFGGGFFFFFFFFGGGGGGGTGGGGTGGTGLLIIIIGGGGL~`````~LGGTGGGGGGFGGGFFFFFCCB~~
~~BBBFFLPPPGTGGGGGPPPGGGGGGGGGGGGGGFFGGGLL~LGGTFFFFFFGLLLLGFFFGGTGFFFFFFFGGTGGGGGGGGGGGGGL~~LIIGGGGGL~``````~LTGGGGGGGGGFFFFFFCCCB~~
~~BGGFL~PPPTGGGFGGPPPGGGGTGTGGGTTGFFFGGL~~`~LGTGFFFFFL~~~~LGGGTTGGFFFFFGGGTGGTTGGGGGGGGGL~``~LGIIGGTGL~~~~~~LGTGGTTGTGTGTFFFFFFCBB~~
~~BGGL~~PPPGGTFFFTPPPGGGGGGGGTFFFGGFTGL~````~LLLGFFGL~````~LGTGGGGFFFFFGTGGGGTGGGGGTTGGTL~``~LGIIIIGGGLLLLLLGGGGTGTGTGGTGGFFFFFB~~~~
~~BTTL~~PPPTGGGFGGPPPGGGGGGGGGFFGGFFFFL~`````~~~LGTGL~````~LTGGTGGGFFFGGGGGGGGGGGGGGGGGGGL~~LGGIIIIIIGTGGGGGGGGGTGGGGGGTTGFTBBB~`~~~
~~BGGL~~PPPGTGGGGGPPPGGGGTGGGTFFFGFFFFFL~```````~LGGFL~~~~LGGGTTGGGGGGGTGGGGGGGGGGGGGGGGGGLLGIIIIIIIIGTTGGGGGGTGGGTGTGGGGGTB~~~``~~~
~~BGGGLLGGGGGGGGGTPPPGGGGGGGGGFGGGFFFFFFL~``````~LGGFFLLLLGTTGGGGTGGGTTGTTGGGGGGGGGGGGGGGGTTTIIIIIIIIIGGGGGTFFGGGGGGGTGGGGB~`````~~~
~~BGGGGGGGGGGGGGGTPPPGGGGGGGGGFFFFFFFFFGGL~````~LGGTGFFFFFFTGTGGGTTGGGGGGGGGGGGGGGGGGGGGGGGGTGIIIIIITGGGGGGFFFGGGGGGGGGTGB~````~~~~~
~~BGGGGGGGGGGGGGGGPPPGTTGGTGGFFFFFFFFFFFGGL~``~LGGGTGTFFFFFTGGFTGGTTGGGGGGGGGGGGGGGGGGGGGTGGGGIIIIIITTGGGTFFFFGTTGGGGGTGB~```~~BBB~~
~~BGGGGGGGGGGGGGGGPPPTGGGGGGGGFFFFFFFFFFGGGL~`~LTGGGTGGFFGGGGGFFFGGGGGGGGTGGGGGGGGGGGGGGGGGTTGTGTGTGGGTGGGTGGGGGTGTTGGGGGB~~~BBGTB~~
~~BGGGGGGGGGGGGGGGPPPGTGGTGGTGGFFFFFFFGGGGTL~`~LGTFGGGGGGFGGGFFFTGGTGGGGGGGGGGGGGGGGGGGGGGTGGGGGGTGGGTGTGGGGGGGGGTTTLGGGTGBBBGGTIB~~
~~BGGGGGGGGGGGGGGGPPPGGGGGLLTGGFFFFFTFTGGGL~```~LTGGGGGGTFGTGGFGGGGGGGGGGGGGGGGGGSGGGGGGGTGLLLLGTTGTGGLLGGTGGGGTGGGL~LGGGGGGTGGIIB~~
~~BGGGGGGGGGGGGGGGPPPGGGTL~~LTGGGFIGGGGTGGL~```~LGGGGGGGFFGGGGGTGIIGGGGGTGGGGGGGGGGGGGGGGGL~~~~LGGGGGL~~LGGGGTGGGGL~`~LTGGGGGIIIIB~~
~~BGGGGGGSGGGGGGGGPPPGGTL~`~LGGGGIIIIIGGGGGL~``~LGGFTGGGGGGLLLTGGGIIGGTTGGGGGGGGGGGGGGGGGL~````~LGGTL~``~LGGGTGGGGL~`~LTGGGGIIIIIB~~
~~BGGGGGGGGGGGGGGGPPPGGTTL~LGGGGIIIIIIGGIGGTL~~LGTGFGGGGGGL~~~LGGIIIGGGGGGGGGGGGGGGGGGGGGL~````~LGTGL~``~LGGGGGGGL~``~LGGTGGGIIIGB~~
~~BGGGGGGGGGGGGGGGPPPGGGGGLGGGGGGIGIIIITIITGTLLGGGGGGGGGGL~```~LGIIGGTGGGGGGGGGGGGGGGGGGGL~````~LGGGGL~~LGGGGGGTGL~```~LGGTTGGGGGB~~
~~BGGGGGGGGGGGGGGGPPPTGGGGGGTGGLLTGIIIIIIIITGGGTGGGGGGGGL~`````~LIIGTGGGGGGGGGGGGGGGGGGGGFL~~~~LGGGGGTLLGGGGTTGTGTL~``~LTGGGGGGGGB~~
~~BGGGGGGGGGGGGGGGPPPTGGGGGGGGL~~LGIIIIIIIFFGGGGTGGGGGTGL~`````~LIITGFGGGGGGGGGGGGGGGGGGGFFLLLLGGGGGGGGGGTGGTGGGGGL~`~LGTTGGGGGGGB~~
~~BGGGGGGGGGGGGGGGPPPTGGTGLGTL~``~LIIIIIIIFFGGGGGTGTGGGGGL~~~~~~LIIIGFGGGGGGGGGGGGGGGGGGGFFFFTGGGGGGGGTTGGGGGGTGTL~``~LGGGGIIIIGGB~~
~~BGGGGGGGGGGGGGGGPPPGGGGL~LL~```~LIIGFFFFFFTGGGGGGGGTGGGGLLLLLLIIIICFFFFTFGTGGGPPPHTGGGGGFGGGGGTGGGGGTGTTTGTGGGL~```~LGTGGGIIIGGB~~
~~BGGGGGGGGGGGGGGLPPPGGGL~`~~`~~~~LIGGGGFFFFGGGTGGTTGGGTFFFFFFFFIIICCCFFFFFFFFGFPPPGGGGGTFFFGGGGGGGTGTTTGGTGGGTGL~```~LGGTGGGIIGTB~~
~~BFFFFFFTGGGTTGL~PPPGGTGL~`~~LLLLGGGGGGGGGGGGGGGGGGGGGFFFFFFFFFGTCCCCCFFFFFFFFFPPPGGGGGGGFGGGGGGGGGGGGGGGGGGTGGGL~``~LGGGGGTIGGTB~~
~~BFFFFFGGGGGGGL~~PPPLLLGGL~LLGGGGGGGGGGGGGGGGGGGTGGGGGGFFFFFTGGGGGCCCFFFFFFFFFFPPPGGGGGGFFTGGGGGGGGGGGGGGGGTGGGGL~``~LTTGGTTIIGTB~~
~~BFFFFGGGGTGGL~`~PPP~~~LTGLGGGGGGGGGGGGGGGGGGGGTGTGGTGGFFTFFFGGGTGLLFFFFFFFFFFFPPPPPGGGTFFGGGGGGGGGGGGGGGGGGTGGGGL~~LGGGTGGTGGTGB~~
~~BFFFFGTGGGGL~``~PPP~``~LGGTGGGGGGGGGGGGGGGGTGGGGTGTTGTGGGFFFFFFTL~~LFFFFIIFFFFPPPPPPGGGGGGGGGGGGGGGGGGGGGGGTGGGTGLLGGGTGGGGTGGGB~~
~~BGFFGGGGGTTL~``~PPP~``~LGTGGGGGGGGGGGGGGGGGGGGGGGGGGGFFFGFFGGFFL~``~LFFFLGIIGTPPPPPPPTTGGTGGGGGGGGGGGGGGGGGGGGGGGGTTGGGGGTGGTGGB~~
~~~BBGGGTGGGGL~``~PPPL~~~LGTGGGGGGGGGGGGGGGGGGGTGGLLLGFFFFFGGGGGL~````~LFL~LIIITGTPPPPPPPPGGGGGGGGGGGGGGGGGGGIIGGGGGGGGTGGGGGGGGGB~~
~~~~~BGGGGGTGGL~`~PPPPPPPPPPPPGGGGGGGGGGGGGGGPPPGL~~~LGFFFFTTTGL~`````~LGL~LIIIGTGGPPPPPPPTGGGGGGGGGGGGGGGGGIIIIGGGTFFTGGGGFTGTGGB~~
~~~``~BGGTGGTGGL~~PPPPPPPPPPPPGGGGGGGSGGGGGGGPPPL~``~LTGLFFFFFFL~`````~LIGLIIIIIIIGGPPPPPPGGGGGGGGGSGGGGGGGGIIIIIGGFFFFGGGFFFGTGGB~~
~~~``~BGGFGTTTGGLLPPPPPPPPPPPPGGGGGGGGGGGGGGGPPP~```~LGL~LFFFFFL~````~LIIIIIIIIIITFFFFFPPPTTGGGGGGGGGGGGGGGGIIIIIGGTFFFFGGFGGFGFFB~~
~~~~~BGGGFGGTTGGGGGGTTL~~~~~PPGGGGGGGGGGGGGGGPPPL~```~L~`~LFFFFGL~```~LIIIIIIIIIIIGFFFFPPPGGGGGGGGGGGGGGGGGIIIIIIGGGFFFTGGGTTFFFFB~~
~~BBBGTGTGGGTGGTGGGGGGL~```~PPGGGGGGGGGGGGGGGPPPTL~```~``~LFFFGGTL~~~LGIIIIIIIIIIGGFFFFPPPGGGGGGGGGGGGGGGGGIIIIIIGGGGFGTGGGGFFFFFB~~
~~BGGGGGBBGGGGGGGGTGTGGL~~`~PPGGGGGGGGGGGGGGGPPPTTL~````~LTFTGGGGGLLLGTIIIIILLLIITGGGGFPPPGGGGGGGGGGGGGGGGGIIIIGGGGGGGGGTGGTTFFFFB~~
~~BGGGTB~~BGGTTGGGGGGGTGLL~~PPGGGGGGGGGGGGGGGPPPGGGL~```~LGGGTGGGGGGGGGFFIIL~~~LGGGGGTGPPPTGGGGGGGGGGGGGGGGIIIIIIIFFGFGTGGTGGGFFFB~~
~~BGGGTB~`~BGTGGGTGGGGGGGGLLPPGGGGGGGGGGGGGGGPPPGFTGL~``~LLGTGTGGGGGGFFFGGL~```~LGGGGGTPPPGGGGGGGGGGGGGGGGGIIIIIIIFFFFGGGGGGTGGGGB~~
~~BGGBB~~~BGGGGGGGGGTGGGGFFFPPGGGGGGGGGGGGGGGPPPFFFTGL~``~~LGGGGGGGFFFFFFGL~```~LGGGIIIPPPGGGGGGGGGGGGGGGGGIIIIIIIFFFFFGGGTGTGTGGB~~
~~BBB~B~BBGGGGGGGGGGGGTTGFFFPPPPPPPPPPPPPPPPPPPPFFTGGL~~~~~~LGGGGGGGGFFFFFL~``~LGTGGIIIPPPGGGGGGGGPPPGGGGGIIIIIIIIFFFFTGTGGLLGGGGB~~
~~~~~`~~BGGGGGGGTGLLGGTGGGFFPPPPPPPPPPPPPPPPPPPPPPPPPPPPPPPPPPPPPPPPPPPPPPPP~~LGGGTIIIIPPPGGGGTGGPPPPGGTGGGIIGTGIIFFFGGGTGL~~LGGGB~~
~~~```~BGGGTGLLTGL~~LLTGGGGFGGGTGGGGL~~~~~~PPPPPPPPPPPPPPPPPPPPPPPPPPPPPPPPP~LGGGGGGITIPPPGGGGGGGPPPPGGGGGGGGGGGGFFTFGGTGL~``~LGGB~~
~~~~~~BGGGTTL~~LGL~`~~LGGGTTGGTGGGGGL~`````~PPPPPPPPPPPPPPPPPPPPPPPPPPPPPPPPPPPPPPPPPPPPPPPPPPPPPPPPPGGTGGGGGGGGGFFGGGTGL~````~LGB~~
~~~BBBGGGGGL~``~LL~```~LGTGGGGGTLLGGL~```~~LGPPPPPPPPPPPPPPPPPPPPPPPPPPPPPPPPPPPPPPPPPPPJPPPPPPPPPPPGGTGTGFFFFGGGGGGGGGGL~````~LGB~~
~~BGTTTGTTL~```~LL~```~LGGGGTGGL~~LGGL~~~LLGGGPPPPPPPPPPPPPPPPPPPPPPPPPPPPPPPPPPPPPPPPPPPPPPPPPPPPPPGGGTGTFFFGTGGGGGGGGGL~```~LGTB~~
~~BGTGTTGTL~`~~LTGL~``~LGGGGGTGL~`~LGTLLLGGGGFFFFFFFFFGGTGGGGGGGTGGGGGGGTGGGIIIIIIIIIGGPPPGGMTGGGGGGGGGGGGFFFFFGGTGGTGTGGL~~~LGTGB~~
~~BFGGGGGL~`~LLGGTGL~~LGGGGTGTTL~``~LTGGGGGGGFFFFFFFFTGGTGGGGGGGGGTGGGGTGGIIIIIIIIITGGGPPPGGTGGGTTTGGGGTGGFFFGFTGGGGTGGGGTLLLTTGGB~~
~~BFFTTGGL~~LGTGTGTGLLGGTGGGGGTGL~~LGGTGGGGGFGFFFFFFFGGGIGGGGGGGGGFFFGFFFFFIIIIIIIGGGGGPPPGGTGGGGGGTGLLGTGTTGGFTGGGGGTGTFGGGGGTGGB~~
~~BFFFFGGGLLGGGGGGGGGGTGTGGFTIIIILLGGGGGGTGGFGFFFFFFFTGIIGTTGGTGGGFFFGFFFFFFFFIIIIGGTGPPPPFGGGGGGGGGL~~LGGGGTGGGTTGTGTFGFFGGGGGGTB~~
~~BFFFFTTGGGGGGGGGGGTGGFGFFFIIIIIGGTTGGGGFFFFFFFFFFTGGIIIIGGGLGTTGFFFFFFFFFFFFIIIPPPPPPPPPFFGGTTGTGL~``~LGTGTFFGGTGGGGGTTFGTGTGGGB~~
~~BFFFFTGGGGTTGTGGGIIIIFFFFFIIIIGGGGGGGGFFFFFFFIIIGTFFIIIIGGL~LGGTFFFFFFFFPPPPPIIPPPPPPPPPFFGFGGGGL~````~LGGFFFGTGFGGGGGGGGGGTGGGB~~
~~BFFFFFGGGGGGGGTGIIIIIIFFFFIIIGGTGGTGTGFFFFFFFFGGTFFIIIIGGL~`~LGFFFFFFFFFPPPPPIPPPPPPPPPPFFFFGGGGL~````~LGFFFFTFFFTTGGGTGGTGGFGGB~~
~~BGFFFFFGLLLGGTGIIIIIIGIIFIIIGGTGGGGGGTFFFFFFFTGGGTGTIIITGL~`~LGFFFFFFFFFPPPPPPPPPPFFFPPPFFFFGGGGL~```~LGFFFFGGGGGTGTGGGGGGGGFFGB~~
~~BGGGFFFL~~~LTIIIIIIIIIIIIIIIGGGGGGGTGGTGFFFFFLTTGGGTGIIGGGL~~LTFFFFFGGGIPPPPPPPPPPFFFPPPFFFGTGGGGL~~~LGGFFFFFFGGGGGGTGGGTGFFFFFB~~
~~BBBBGGL~```~LFIIIIIIIIIIIIIIGGGGGGGFFGGGTFFFL~LGIITGGGGTGGGLLGFFFFFFFIGIPPPPPPPPPFFFFPPPFFFGGGGTGGLLLTGFFFFFFFFGGGGGGTGGTGTFFFGB~~
~~B~~~BL~````~LIIIIIIIIIIIIIIGGGGGGGGGFGGGGGFL~`~LIIGGGGGGFFTGTGGGFFFFGIIIPPPPPPPPGGFFFPPPFFFFFFFGGGGGGGGFFFFPPPGGGGGGGGGGTGTFGTGB~~
~~~``~BL~````~LGIIIIIIIIIIIIIIGGGGGGGTFGGGGGGL~``~LIGGGTGFFFGGGGGGGTFGGGIPPPPPPPTGGGGFFPPPFFFFFFLLTGGTGTGFPPPPDPGGTGGTGGGGGGGGGGGB~~
~~~``~BL~```~LTGIIIIIIICIIIIIIGTGGGGGGGGTGGTGGL~`~LIITGGGFFFTGTGGGGGFGGGGPPPPPPPTGGGGFGPPPFFFFFL~~LGGGFFFFPDPPPPGTGGGGGTGGGGGGTGGB~~
~~~~~BGGL~~~LGTGGPPPIICCCIIIIIIGGTGTGTGGTGGGGGL~`~LTGGGGTFFFTGTGGGTGGFGGGPPPPPPPGGGGGGGPPPPFFFL~``~LGGGFFFPPPPPPGTGGTGGGTTGTGGGGGB~~
~~BBBGGGGLLLGGGGGPDPICCCCCIIIIIGGGGGGGGTGGTFFFL~~LGLLLTGGFFGGGGTGGTFFFFFGPPPPPPPGGGGTGGPPPPFFFL~``~LGGTFFFPPPPPPGGGGGGGGTGGGGGGFFB~~
~~BGTGGGGGGGGGGGGPPPIICCCIIIIITGGGGGGTGGGGGFFFFLLGL~~~LGGFGGTGGGGGFFFFFGPPPPPPPPGGGTLLGPPPPPFFL~``~LGGGFFFPPPPPPGGGGGGGTGGGTGFFFFB~~
~~BGGGGGGGGGGGGGGPPPTGGCIIIIIIGGTGGTGGTTGGGFFFFGGGL~``~LGGGFPPPPPPPPPPPPPPPPPPPPGTTL~~LGPPPPPFL~```~LLLFFFPPPPPPPPPPPPPPPGFFGFFFFB~~
~~BGGGGTGGGGGGGGGPPPGGGGTIIIIFFGGTGGGGTGTGTTGGTGTGGL~`~LGGGFPPPPPPPPPPPPPPPPPPPPPPPPPPPPPPPPPPL~~~~L~~~LFFPPPPPPPPPPPPPPPTFFFFFFFB~~
~~BGGFFTGGGTGGGGGPPPGGGGGIIIFFFGGGTGGTTGTTGGGGGTGGGL~~LGGGGFPPPPPPPPPPPPPPPPPPPPDPPPPPPPGPPPPPPPPPPPPPPFFTPPPPPPPPPPPPPPPTFFFFFFFB~~
~~BGTFFFGFGTGGGGGPPPGGGGGGFFFFFGGGGIGGTTGGTGGGGGGGGGL~LTGGGGPPPGTGFFPPPPPPPPPPPPPPPPPPPPGGPPPPPPPPPPPPPPGGPPPPPPPPPPPPPPPFFFFFFFFB~~
~~BGGFFFFFTGGGGGGPPPGGGGGFFFFFFFGGGIPPPPPPPPPPPPPPPPPPPGGGGGPPPGFFFFPPPPPPPPPPP~~~~~~PPPPGTPPPPPPPPPPPPPGGPPPPPPPPPPPPPPPPFFFLFFFB~~
~~BFFFFFFFTGGGGGGPPPGTGTGGGFFFFGTGGIPDPPPPPPPPPPPPPPPPPTGGGTPPPTFFFFPPPPPPPPPPL~``~LPPPDPGGGGGTGGGTGPPPPGGPPPPPPPPPPPPPPPPFGL~LFGB~~
~~BGFFFFFFFFGGGGGPPPHGGGGGGGGFFGGGGIPPPPPPPPPPPPPPPPPPPPGGGGPPGGGGGGGGGGGGGGGGL~`~PPPPPPPPPPPPPGGGGGGPPPPPPPPPPPPPPPPPPPPPTL~`~LTB~~
~~BGGFFFGTGTGGGGGPPPGGGGGGGGFFFFGGGIIGGGGTGTGTGGGTGTPPPPPGGGPPGGGGGGGGGGGGGGGGL~~LPPPPPPPPPPPPPGGFGTTPPPPPPPPPPPPPPPPPPPPPCTL~LGGB~~
~~BGGTGTGGGGGTGGGPPPTTLGGGGFGTFTGGGGIGGTGGGGTGGGGTGGPPPPPPPGPPGGGGGGGGGGGGGGGGGPPPPPPPPGPPPPPPPFFFTGGPPPPPPPPPPPPPPPPPPPPPCCTLGGTB~~
~~BGFGGGTGGGGTGGGPPPLL~LTGGFGGGTGGGTTTTGGTGGGGGTGGGGGPPPPPPGPPGGGGGGGGGGGGGGGPPPPPPPPGGFFFFTPPPFFFFFFGGGGGL~~~~~PPPPPPPPPPCCCGTGTB~~
~~BFFFFTGGGGGGGGGPPP~~`~LTGGGGGGGGGGGGGGGGGTGGGTTGGGTGPPPPPGPPGGGGGGGGGGGGGGGPPPPPPPPGFFFFFFPPPFFFFFFFGFGGGL~~~LPPPPPPPPPPCCGGGGGB~~
~~BTFFFFFLGGGGGGGPPP~```~LGGGGGGGGGGGGGGGGGGFGGGGGGTGGGGPPPGPPGGGGGGGGGGGGGGGPPPPPTGFFFFFFFGPPPFFFFFFFFFFFGGLLLGPPPPPPPPPPCFFTFFFB~~
~~BGFFGGL~LGGTGGGPPPP~~~~~LGGGGGGGGGGGGGGGGFFFFGTGGGGGTFPPPGPPGGGGGGGGGGGGGGGPPPTGGFFFFFFFGLPPPFFFFFFFFFFFFGGGGGPPPPGPPPPPGTFFFFFB~~
~~BGGGGL~`~LGGTTGPPPPPPPPPPPGGGGGGGGGGGGGGGFFFFFGGTGTFFFPPPGPPGGGGGGGSGGGGGGGPPGGGGGFFFFFFL~PPPFFFFFFFFFFFFTGTLGGPPPGPPPPPGFFFFFFB~~
~~BGGGGL~~LGGGGGGPPPPPPPPPPPGGGGGGGGGGGGGGGFFFFFFFFGGGFFPPPTPPGGGGGGGGGGGGGGGPPGGGTFFFFFFL~~PPPGTFFFFGFFFFFFFL~LGPPPGPPPPPGFFFFFFB~~
~~BTGGGGLLGTGGGTGGPPPPPPPPPPGGGGGGGGGGGGGGGFFFFFFGGGGFFFPPPGPPGGGGGGGGGGGGGGGPPGGGGFGFFFFL~~PPPGFFFFFGGFFFFFL~`~LPPGGGGGGGGGGGGGGB~~
~~BGGGGGGGTGGGGGGGGGGTGTTPPPGGGGGGGGGGGGGGGFFFFFFGTGGFFFPPPGPPGGGGGGGGGGGGGGGPPGGGTTFFFFFL~~PPPGGGTFGGFFFGFFFL~LGPPGGGGGGGGGGGGGGB~~
~~BGGGGGGGFGGTGGGGTGTTGFPPPPGGGGGGGSGGGGGGGFFFFFFGTGTTFFPPPGPPGGGGGGGGGGGGGGGPPTGGGGGFFFFPPPPDPTGGGIGGFFGGFFFFLLLPPGGGGGGGGGGGGGGB~~
~~BGGGGGGFFGGGGGTGTGTGGPPPPPGGGGGGGGGGGGGGGFFFFFFTTGGGGFPPPPPPGGGGGGGGGGGGGGGPPGGGGGFFFFFPPPPPPTGIGIIFFFFFFFFFL~~PPGGGGGGGGGGGGGGB~~
~~BGGTGGFFFFGGTGGGGGGGPPPPPPGGGGGGGGGGGGGGGFFFFFFFFTGGTTPPPPPPGGGGGGGGGGGGGGGPPGFGTGFFFFFPPPPFGGFIIIIFFFFGLLLL~`~PPGGGGGGGGGGGGGGB~~
~~BGGGGGFFFFGGGGGGGGGGPPPPPGGGGGGGGGGGGGGGGFFFGGGGGGGGGGGGGGGPGGGGGGGGGGGGGGGPPFFFGFFFGGFPPPFFFFFIIIFFFFGL~~~~``~PPGGGGGGGGGGGGGGB~~
~~BGGGGGFFFGGGTGGGGGGGPPPPGGGGGGGGGGGGGGGGGFFFGGGGGGGGGGGGGGGPPPPPPPPPPPPPPPPPPFFFFFFFFTFPPPFFFFFFIIFGFFL~``````~PPGGGGGGGGGGGGGGB~~
~~BFFFGFFFFFGTTGGGTGTGPPPGGTGGGGGGGGGGGGGGGFFFGGGGGGGGGGGGGGGPPPPPPPPPPPPPPPPPPFFFFFFFFFFPPPFFFFFFGGFGGGGL~~~~~`~PPGGGGGGGSGGGGGGB~~
~~BFFFGFFFFGGGGGGGGTGPPPPGGGGGGGGGGGGGGGGGGFFFGGGGGGGGGGGGGGGGTGGLLTGGGGL~~~LFFFFFFFFFFFFPPPFFFFFGGGGTGGGGLLLLL~~PPGGGGGGGGGGGGGGB~~
~~BFFFFFGFGGGGGGTGTTPPPPPGGGGGGGGLLLLGGGGGGFGFGGGGGGGGGGGGGGGGGGL~~LGGGGL~~~LFFFFFFFFFFFFPPPPPPPPPGGGGGFFFGGGGGLLPPGGGGGGGGGGGGGGB~~
~~BFFFGGFFGTTGGGGGGPPPPPPGTTTGGTL~~~~LGGGGGTTGGGGGGGGGGGGGGGGGGL~``~LLGTGLLLFFFGFFFFFFFFFPPPPPPPPPGGGTTGFGGTGGFFFPPGGGGGGGGGGGGGGB~~
~~BFFTGGGGGGTGPPPPPPPPPPPPPPPPPPPPPPPPPPPPPPPPGGGGGGGGGGGGGGGTL~````~~LGGGTGTFFTFFFFFFFGFPPPPPPPPPGTGGTGFFFGGGFFFPPGGGGGGGGGGGGGGB~~
~~BGTGGTTGTGTPPPPPPPPPPPPPPPPPPPPPPPPPPPPPPPPPGGGGGGGSGGGGGGGGL~``````~LGGGGTGGGGFFFGGGTGGGGGTGPPPTTGGGGFFGGGGFFFPPGGGGGGGGGGGGGGB~~
~~BTGLLGGGGGGPPPPPPPPPPPPPPPPPPPPPPPPPPPPPPPPPGGGGGGGGGGGGGGGGGL~````~LGTGGGGTGFFFFFFGGGGGGGGTTPPPTGGTTFGGGTGGGGFPPGGGGGGGGGGGGGGB~~
~~BGL~~LGTTGGPPPPFGGTGIIIIIIIGFFFFFFGGGGTGGGGGGGGGGGGGGGGGGGGTGGL~``~LGGGGTGGGGFFFFFGGGTGGGTGGGPPPPGFFFFFGGGGGGGGPPGGGGGGGGGGGGGGB~~
~~BGL~`~LTTGTPPPFFFGGGIIIIIIITGTFFFFGGFGGGTGGGGGGGGGGGGGGGGGGTGGTL~~~LGGGGGGGGGFFFFFFGTTGGGGTGGPPPPPFFFFFFGGGGFTGPPPGGGTGPPPPPPGGB~~
~~BGL~~LGGGTPPPPLFFFGGIIIIIIIFGGGFFGTFFFFGGGGTGGGGGGGGGGGGGGGGGGGGLLLGGGGGGGTGGFFFGFFFTGGTGGGGGPPPPPFFFFFGGGFFFFGPPPGGGGTPPPPPPTTB~~
~~BGGLLGGTTPPPPP~LFFIIIIIFFFFFGGGGGGFFFFFGGGTTGGGGGGGGGGGGGGGTGGGFGTGGGGTTGTGGGGTGGFFGTTGGTGGGGGPPPPFFFFGFFFFFFFGPPPGGTGGPPPPPPGTB~~
~~BGGGGGGGPPPPPPLFFIIIIIFFFFFFGGGFFFFFFFFFFGGGGGGGGGGGGGGGGGGGTGFFFGTGTGLGGGGGGGGTTGGGTGTGGGTGGGGPPPTGFFGGFGFGGGGPPPTGTGGGGGPPPGGB~~
~~BGGGTGTGPPPPPGGFFIIIIGGFFFFFFFGFFFFFFFFFFGGGGGGGGGGGGGGGGGGFGGFFFGGGLL~LGGGGGGGGTGGGGGGGGGGGGGGPDPGGGGGGGGGTGGGPPPGTTGGGTGPPPGTB~~
~~PPPPPPPPPPPPGGFFFFGGGFFFFFFFFFGGFFFFFFFFFTGLTGGGGGGTGGGGGGGFTFFFFFGL~~`~LGGGCGGGGGGGTGGGTGGGTGGPPPTGTGGGGTGGGGGPPPTGGTGGGGPPPGGB~~
~~PPPPPPPPPPPGGGFFGFGTGGFFFFFFGGGFFFFFFFFFTGL~LGGGGGGGGGGTGTFFFFGGFGL~````~LGCCCGTGGGGGGGFFFGFGTGGGGGTGTGGGGGGTGTPPPGGGGGGGGPPPGTB~~
~~PPPPPPPPPPPGGGTGGFGTGGGFFFFGGGFFFFFFFFFGGL~`~LGTGTGGTGGGGFFFFFFFGGL~`````~LCCCCGTGGGGGGGFFFFFGGTGGTGGTTGGTGGGGGPPPGTGTTGGGPPPPGB~~
~~PPTGGGGGGTFGGGGFFGFGGGTGFGFGGTGGFFFGGFFTTL~`~LGGGGGGGGFGTFFFFFFFFGL~``````~LCCGGTGGGGGGGFFFFFFFGGGTGTGGGGGGGGGGPPPPTGGTGTGPPPPPP~~
~~PPGGGGGTGGFTGGFFFFFGFFFTGGTGGGGGGFFTGTGGGGL~LGGTTGTGGFFGGGGFFFFFFFGL~~~````~LGTGGGGGGFGGTFFFFFGGGGGGGGGGGGGTTGGPPPPPGGGGGGPPPPPP~~
~~PPGGGTGGGFFFFGGFFFFGFFFFLGGTTGGGGFGGGGGGGGGLGGGGGGGGFFFFGGGFFFFFFGGGLLL~```~LGGGGGGTGFGGTFFFFFFGTGGLLLLGGTGGGGGPPPPPGGGGGGGPPPPP~~
~~PPGGTGGTGFFFIGGGFFFFFFFL~LGTGTGTGGTTGGGGGGGGGGTGGGGFFFFFGTGFFFFFFFFGGGGL~``~LGTGGGTGGGGGGGFFFFFFTTL~~~~LGGTGGGGGPPPPGTGTGTGTGGPP~~
~~PPGGTGGGGFTIIIIFFFFFFFFFLTGTTGGGGGGGGGGGGGGTGTGGGGFFFFFFGGGGFFFFFFFTGGGL~``~LGGTTGGGGGGGTGFFFFGFGL~```~LTTGTTTGTGPPPGGTTGTGTGTPP~~
~~PPGGGGTTTTGIIIIFFFFFFFFFTGGTGGGGGGGGGGTGGGGGTGGGGTGFFFFFFTGGGFFFFFFGGGTL~``~LGGGGGGGGGFGGTGFFFFFFL~```~LGTTGGGGTGPPPPGGGGGGFGTPP~~
~~PPGGFTGGGTGGIIGFFFLLLGGFGGGGTTGGGTTTGGGGTGGGTGGGTTTGGFFGGTGGFFFFFFGGGGGGL~~LTFGGFGGGGGGTTGGGGGFFFGL~~~LGTLLLGGGTGPPPPPGGFGFFGGPP~~
~~PPGGGGGGTGGGIIGFLL~~~LGTTGGGGGGGGGGGGGTGGTGGGGGGGGGGGLLLGGGGGFGGGGGGGTTGGLLGFFFFFGGGTGTGTGGGGGGFGGGLLLGGL~~~LGGGGPPPPPPGFFFFFFPP~~
~~PPGGTGGGGGGGFFFL~~```~LGGTGGGGGGGGGGTGGGGGGGGGGGTGGGL~~~LGGGTTGGGGGTGGGTTGGGGFFFFFTTGGGGGGGGGGGTGGTGTGTL~``~LGGTGGPPPPPPFFFFFHPP~~
~~PPMGGGGGGGGGGGL~~~~~~~LGGGGGTGGGGTGGGGGGGGGTGGGGTGGGL~~~~LGGGGGGGGGGGGGGGTGGGFFFFFFGGTGGGGGTTGGGGGGGGGGL~~~LGGGGGTTPPPPPFFFFFMPP~~
~~PPPPPPPPPPPPPPPPPPPPPPPPPPPPPPPPPPPPPPPPPPPPPPPPPPPPPPPPPPPPPPPPPPPPPPPPPPPPPPPPPPPPPPPPPPPPPPPPPPPPPPPPPPPPPPPPPPPPPPPPPPPPPPPP~~
~~JPPPPPPPPPPPPPPPPPPPPPPPPPPPPPPPPPPPPPPPPPPPPPPPPPPPPPPPPPPPPPPPPPPPPPPPPPPPPPPPPPPPPPPPPPPPPPPPPPPPPPPPPPPPPPPPPPPPPPPPPPPPPPPJ~~
~~~~~~~~~~~~~~~~~~~~~~~~~~~~~~~~~~~~~~~~~~~~~~~~~~~~~~~~~~~~~~~~~~~~~~~~~~~~~~~~~~~~~~~~~~~~~~~~~~~~~~~~~~~~~~~~~~~~~~~~~~~~~~~~~~~~
~~~~~~~~~~~~~~~~~~~~~~~~~~~~~~~~~~~~~~~~~~~~~~~~~~~~~~~~~~~~~~~~~~~~~~~~~~~~~~~~~~~~~~~~~~~~~~~~~~~~~~~~~~~~~~~~~~~~~~~~~~~~~~~~~~~~
