~~~~~~~~~~~~~~~~~~~~~~~~~~~~~~~~~~~~~~~~~~~~~~~~~~~~~~~~~~~~~~~~~~~~~~~~~~~~~~~~~~~~~~~~~~~~~~~~~~~~~~~~~~~~~~~~~~~~~~~~~~~~~~~~~~~~
~~~~~~~~~~~~~~~~~~~~~~~~~~~~~~~~~~~~~~~~~~~~~~~~~~~~~~~~~~~~~~~~~~~~~~~~~~~~~~~~~~~~~~~~~~~~~~~~~~~~~~~~~~~~~~~~~~~~~~~~~~~~~~~~~~~~
~~BBBBBBBBBBJBBBBBBBBBBBBBBBBBBBBBBBBBBBBBBBBBBBBBBBBBBBB~~~BBBBBBBBBBBBBBBBBBBBBBBBBBBBBBBBBBBBBBBBBBBB~BBBBBBBBBBBBBBBBBBBBBBBBB~~
~~BCCCGGGGGGPGGTGGGGGGGGTGTGTGGGIIGTIIIIIIITIIFFFTGGGGGGFBBBGTGGGTGGGGTTTGGGGTGGFFFFFGGGGTGGGGGGGTGGGGB~`~BTGGTGIGGTGGTGGGTTGGCCCB~~
~~BCCGGHPPPPPPPPGGTGTGGGFGGGGGGIIIIIIIIIIIIIIIFFFFGGTGTGFFGGTTGGGGGGGLLLLTTGGGGFFFFFFTGGGTTGTGGGTGGTGGB~``~BGGGGIIGGGGGGGGTLLGGCCB~~
~~BCGTGTPPPGGPPPGGTGTGFFFIIIIIIIIIIIGIIIIIIIIIFFFFGGGTGFFFFGTGGGTGGTL~~~~LGGGGGFFFFFFGTGGTTGGGGGGGTGGGB~``~BGGGTIIGGGGGTGTG~~GGGCB~~
~~BGGGGTPPPGGPPPTGGGTFFFFIIIIIIIIIIGGGGGTIIIIIFFFFFGTGGFFFFFGGGGGTGL~````~LTGGGTFFFFGGTGGGGGGGGTTGGGGGB~`~BGGGGTGIGGGGGGGTGLLGGGGB~~
~~BGTTGGPPPGGPPPGGGGFFFFIIIIIL~LIIGGGTTTGTIIIIFFFFFGGGGGFFFFFGGFFGL~`````~LGGGGGGFFFGGGGGGGGGGGTTGFGFGB~~BGGGTTGGGGGTGGGGGGGGGGGGB~~
~~BGFFGPPPPGGPPPGGGTGFFFIIIIL~`~LGFGGGGGGGTGGGFFFFTGGFGGTFFFGGGFFFL~```~~LTTTGGGFFFGGGGGGGGGGGGGGGFFFB~`~BGTGGGGGGGGGGGTTGGGGGFFFB~~
~~BGGFGPPPPGFPPPTGGGFFFIIIIIL~~~LFFFFFGGGGGGGGLLLTGGTFFGGGFGGGFFFFFL~~~LLFGGGGGGFGFTTGGGTTGGGGGGTFFTB~```~BTGIIIGGGGGTGGGGGGTGFFFB~~
~~~BBFGPPPPGFPPPGGGTGGIIIIIIGLLLFFFFFFGGGTGGGL~~~LTGGGGGGGGGGFFFFFFGLLLGFFGFFFTGGGGGTGGGTGTGGTTGFFFB~````~BGIIIIGGGTGGGGTGGGGGFFFB~~
~~~~~BGPPPGFFPPPGGFFFTIIIIGGGTTTFFFGGGGGGGGGL~```~GGGGGGGGGTGTFFFFGTGGGGFFFFFF~TTGGGTGTTGGGTGGTGFFFFB~```~BTIIIIGGGTGGGTGGGTGFFFFB~~
~~~`~BGPPPGFFPPPGTFFFFIIGGGTGGGGFGGTGLLLGGGGL~``~LGGTGTGFGGGGGFFTGGGGTTTFFFFFFGGGGGGGGGGGGTGGGGGGFFFFB~~~BGGIIIITGGTGGTGTGGTTFFFFB~~
~~~`~BGPPPGFFPPPGGGFGGIGGGFFTGTTGGGGL~~~LLGGGL~~LIIGGGFFFFGTGGFFFFGGGGGGFFFFFGTGGGGTTGGGGGGGGTGGGTFFFFBBBGGTIIIIIGTGTGGGGGGGFFFFFB~~
~~~~BGGPPPGGFPPPGGGGGGGTFFFGTGGGGGGL~```~~LTGTLLFIIGGGGGFFFFGFFFFGTTGGGGFFFFGGGGGGGGGGGTGTTGTGGTGGFFFFFFFFGGIIGIIGGTGGGGGGTGGFFFFB~~
~~BBGGGPPPGGGPPPGGTGGGGGFFFFTGGFGTL~``````~LLGGTFFFFGGGFFFGGTFFFFFTGTGGGGFGGGGFGTGGGGGGGGGL~LTTGGTGGLLLLLTGGIIIIIGGTGGGGGGTGTFFFGB~~
~~BGGGGPPPGGGPPPGGGGGTGGFFFGFFFFFGL~```````~~LLGFFFGFGGFFFGFGFFFFFGGTGGGGGGGFFFFGGGGGFTGGG~`~GGGTGGL~~~~~LTGIIIIGGGGGGGGGTGTTFFFGB~~
~~BGTGGPPPGGGPPPGGGGGGGTFFFFFFFFFFGL~````````~~LFFGGFGGFFFFFFFFFGGGGTGGGGGGGTGFFFFFFFFFTGGL~LGGFGGL~`````~LGIIIIGTGGGGGGGTTGTGGTTB~~
~~BGGGTPPPGGGPPPGGTGGTTTFFFFFFFFGGTGL~`~~~~```~LFFGFFFFFFFFFFFFFFCFGGGGGGGGGGGFGFFFFFFGGGGTGFGFFFGL~``````~LGTIGGGTGGGGTFFFFTGGGB~~~
~~BGGGGPPPGGGPPPGGTGGGGFFFFFFFFGTGTGGL~LLLL~~`~LFFTFFFFFFFFFFFFFCCCGGTGGGGTGGGGGFFFFFFLLGGGFFFFFFGL~``````~LGGGGGGTGGGGGGFFFGTGB~~~~
~~BGGTTPPPGGTPPPTGGGGGFFFFFFFFFGGGGGGGGGGGGLL~LGGFGGFFFFFFFFFFFCCCCCGGGGTGGGGGTTGFFFLL~~LGGFFFFFGGGL~`````~LGGGTGGGGTTGGFFTTGGGB~~~~
~~BTGGGPPPGGGPPPGTGGGTFFFFFFFFGGGGGGGGTTGGGTGGGGTGGGFFFFFFFFFFFFCCCGGGGGTGGGGGGGGGFL~~``~LGGGFFFGGGGL~~~~~LGGGGGGTGGGGTGGGGGGGGB~~~~
~~BGGGGPPPGGGPPPTGGGGGGFFFFFFGGGGGGGGGGGTGGGTGGGGGGGGFGGFFFGGFFFGCGGGGGTGGGTGTGGTGL~````~LGGIIGTGGGGGLLLLLGTGGGGGL~LGTGGGGGGGGB~`~~~
~~BGTGGPPPGGGPPPGGGGGGGFFFFFGTGGGGGGGGGGTGGGGGTGGGTGGGGGTTGGTTFTGGGGTGLLLLLLGGGGTL~`````~LGIIIIGGGGGTGGGGGGGTGGGL~`~LGFTGGGGGGB~`~~~
~~BTGGGPPMTGTPPPGGGGGTFFFFFTTFGGGGTGTGGTGTTGTTGGGGGGGGGGGGGGTGTGGGGGGL~~~~~~LGGGGL~`````~LGIIIIITGGGGGGGTGTGGGGGL~`~LFFFGTTGGGIB~~~~
~~BGGGGPTL~LTPPPGGGGGGL~LGGFFFFGGGGTGGTGGTTGGGTGGGGGTGGGGGGGGFGGGGTGL~````~~LTGGTGL~~~~~~LGIIIIGGGTGGTGGGGTGGGTGGL~LGFFGTGGGGGGGB~~~
~~BGGGGPGL~LGPPPPPPTGGL~LFFGGGFGLLGGGGGTGGGGGGGTGGTGGTGGTGGTGFFGGGGGL~```~GGGGGGGGGGGGGGGGGILLGGFGGGGGGGGGGTGGGGGGTGFFFFGTGTGTGGGB~~
~~BGGTGPPGPGGPPPPPPGGGGGGGFGGGFL~~LLGGTGTGGGGGGGGGGGTTGGGGGTFFFFGGGGFL~``~GGGGGGGGGGGGGGGGGL~~LGFFGGGGGGGGGGGTGGGGGGGFFFGGGGGGGGGB~~
~~BGGGGGGGGGGGGGGPPGGGGGGTGGFGL~``~~LLL~LGGGGGTGGGGGGGGGGTGGGGFGGFFFFL~``~GGGGGGGGGGGGGGGGL~``~LFFFGGGGGGGTGGTTTGGGGFFFGGGGGGGGTGB~~
~~BGGGGGGGGGGGGGGPPTGGGGGGGGFFL~````~~~`~LGGGGGGTGGGTLLGFGFGTGTTGFFFGGL~~LGGGGGGGGGGGGGGGGL~``~LFFFFFGGGGGGGGGGTTTGFFFFFGGGGGGTGTB~~
~~BGGGGGGGGGGGGGGPPGGGTGGGGGFGGL~~~`````~LGGFGGGTGGGL~~LFFFFGTGGTTFFGGTLLGGGGGGGGGGGGGGGGTGL~~LFFFFGGGGGGGGGGGGGGGGFFFFGGGGGGGGGTB~~
~~BGGGGGGGGGGGGGGPTLLGGGGGGFFFGTLLL~````~LGFFFFGTGGGL~`~FFFFGGGTGGGGGGGGTGGGGGGGGGGGGGGGGTGTLLFFFFFFGGGGGTGGGGGTGGTFFFGGTGGGTGGIIB~~
~~BGGGGGGGGGGGGGGTL~~LGGGGFFFFFGGGTL~```~LFFFFGGGGGGL~~LFFFFGTTGTGGGGGFFGTGGGGGGGGGGGGGGGGTGGTFGFFFGTGGGTGGGGGGGGGGFFFFFFFGGGTGIIB~~
~~BGGGGGGGGGGGGGGP~`~LGGTGFFFFGGTGGL~```~LGGGFGGFTGGGLLFFFGFFGGGGGTFFTFFGTGGGGGGGSGGGGGGGGGGGGGGGGFFFGTGGGGGGGGGGGGFFFFFFGGTGGTIIB~~
~~BGGGGGGGGGGGGGGGL~~LTTFFFGGTGTGGIIL~``~LGGGGGTFGGGGTFFFFFFFGGGGGTFFFFGGGGGGGGGGGGGGGGGGGGGGGGGTFFFFGGGGFGTLLGGGTGFFFFFGGGGGIIIIB~~
~~BGGGGGGSGGGGGGGPGLLGGGFFFFTGGGGIIIL~`~LGGGGGGFFFGTGFFFFFFFFFGGGTTGFFFGGGGGGGGGGGGGGGGGGGGGGGGGFFFFFGGFFFGL~~LGGGGFFFFFFGGGGIIIIB~~
~~BGGGGGGGGGGGGGGPPGGGGGFFFFGTTIIIIIIL~LTGGGGTFFFFFGGTTTGFFFFIGGGGGGFGGTGGGGGGGGGGGGGGGGGGGGTGGGFFFFFGGFFFL~`~LGGGGGGGGFGGGGGGGGGB~~
~~BGGGGGGGGGGGGGGPPGFGGTFFFFTGGIIIIIIIIITGTGGFFFFFFFFFFGGGFFIIIGGGGGGGTGTGGGGGGGGGGGGGGGGTTGTGGGFFFFFGTFFFL~`~LGTTGGGGGGTGGGTGTGGB~~
~~BGGGGGGGGGGGGGGPPFFFFFFFFGGGGIIIIIIIIIGGGGGGFFFFFFFFFGGGGIIIIGGGGGGGGGGGGGGGGGGGGGGGGGGFGGGTGGGFFTGGFFFFL~~LGGGFGFFGGTGGGGTGGGGB~~
~~BGGGGGGGGGGGGGGPPFFFGGFFGTGGGIIIIIIIIGGTTGGGGFGFFFFFFGGGGTIIIIGGGGGGGGGGGGGGGGGGGGGGGGGFGTGGTFGGFGGGFFFFFLLGGGGFFFFFFGGTGFFGGGTB~~
~~BGGGGGGGGGGGGGGPPFFFFGTGGGLLLIIIIIIIIIGGGTGGGGGFFFGFGGGGGIIGGGGGGGTGGGGGGGGGGGGGGGGGGGGFFFFFFFFGFGGGFFFFFFFGTFFFFFFFFGGIIIIGGGGB~~
~~BGGGGGGGGGGGGGGPPFFFGGGGTL~~~LGIIIIGTGTGGGGGLLTFGGGFGTGGGGTGGGGGGGTGFFFFFGTGTTPPPGGGGTGFFFFFFFFFFFGGGFFFFFGGTGGFFFFFFGGIIIIGGGGB~~
~~BGGGGGGGGGGGGGGPPFGGGTGGL~``~LGTIIGGGTGGGGGL~~LFGGGGTGGGGGGTGGTGTGFFFFFFFGGGGGPPPGTTGGGGFFGGGFTTGFGGTTFGGGGGTTGGFFFFTGGIIIIGGTGB~~
~~BFFFFFFFGFFFFFPPGL~LLTGGL~`~GGGGGGGGGGGGGGG~`~LGGGGGGGGGTGGGFGGGTGFFFFFFGTGGGGPPPGGGTGGGFFGGGGGGGGGGGGGGGGGGTGTGGGGFGFTIIIIIIGGB~~
~~BFFFFFFFFFFFFFPGL~`~~LGFFL~LGGGGGGGGGGGGGGGL~~LGTGFGGGGGGGGGFFGGTGTFFFFFGGTGGGPPPGGGGTGFFFGGGGGGGGGGGGGGGGGFFGGGGGGGFFFGGIIIITFB~~
~~BTGFFFFFFGFFFFPGL~```~LFFFFGGGGGGGGGGGGGGGGTLLGFFFFGGGGGGTGGFFGGTGGGLLLGGGGTTTPPPPPGGGGFFFGGGGGGGGGGGGGGGGGGGGGGGGGGGFFTTTIIIIFB~~
~~~BFFFFFFFGGGFFPGL~```~LFFFGGGGGGGGGGGGGGGGGGGGGTGFFGGTTGTGTGGGGTGTGL~~~LGIGGGGPPPPPPGGGFFFGGGGGGGGGGGGGGGFFGGTGTTGGGTGFGGTGIIFFB~~
~~~BFFFFFFFGGGFFPTL~```~LFFFFFGGGGGGGGGGGGGGGGGGTGGGLLLLGGGGTGGGGGTGGL~`~LTIIIIIPPPPPPPGTGFGGGGGGGGGGGGGGGGFFFTGGGFGGGTGGGGFFFFFFB~~
~~BGGFFFGFGTTGFGPGL~```~LFFFFFGGGGGGGGGGGGGGGTTGGIIL~~~~LGGFFFFFGGGGGL~``~LIIIIIIFPPPPPPPPFGGGGGGGGGGGGGGGGFFTGTGGGGGGGGTTFFFFFFFB~~
~~BGGGGGGGGTGTGGPPTL~~~LFFFFFFGGGGGGGGGGGGGGGPPPPGL~````~LFFFFFFFFGGGL~``~LIIGIIITGPPPPPPPGTGGGGGGGGGGGGGGGFFGTGTGGGGGTGGGGFFFFFFB~~
~~BGTGGGTTGGTGGGPPPGLLLFFFFFGGGGGGGGGSGGGGGGGPPPGL~`````~LFFFFFIIIIIIIL~~LIGGGIIIIIGPPPPPPGTGGGGGGGSGGGGGGGFFFFTGGGGGGGGGGGFFFFFFB~~
~~BGGGGGGGTTGGGGPPPGGGTFGGFGGGGGGGGGGGGGGGGGGPPPP~~~~~~~LFFFFFIIIIIIIIILLIIGTGIIIIGTGGGPPPGGGGGGGGGGGGGGGGGFIITGIGGTGGTGGGGGFFFFFB~~
~~BGGGGGGGGGGGGGPPPPGGGTTGTGGGGGGGGGGGGGGGGGGGPPGLLLLLLLGFFFFFGGIIIIIIIIIIIIGGIIIIGGGGGPPPGTGGGGGGGGGGGGGGGIIIIIIGGGGTGGGGGGTGFFFB~~
~~BGGGGGGGGGGGGGPPPPPPPPPPPPPPGGGGGGGGGGGGGGGGGPPGGGGGTGPPPPFFTGTTGGGIIIIIIIIIIIIIGGGTGPPPGGGGGGGGGGGGGGGGGIIIIIIIGGGGGTTGGTGGTGGB~~
~~BGGTGTGGTGGGGGGPPPPPPPPPPPPPGGGGGGGGGGGGGGGGGPPPPPPPPGPGPPFGGGTGTGGGIIIIIIIGGTGGGTGGGPPPGGGGGGGGGGGGGGGGGIIIILLLLGGGGGGTGGGGGGGB~~
~~BGGGGGGGGGGGLLLGPPPPPPPPPPPPGGGGGGGGGGGGGGGGGGGGTGGPTL~LGPTGLLLGGGGGGGGIIIIIGTGGGGGIGPPPGTGGGGGGGGGGGGGGGIIIL~~~~LGGGGGGGTGGGTGB~~
~~BGTGGGGGGGGL~~~LTGGGGGGGGGPPGGGGGGGGGGGGGGGTGTGGGGTTG~`~PPGG~~~TGGGGGGGGIL~LGGGGGGIIIPPPGTGGGGGGGGGGGGGGGIIIL~```~LGGGGTGGTGGGGB~~
~~BTGTGGGGGGL~```~LGTGGGGGGGPPGGGGGGGGGGGGGGGPPPPPPPPPGL~LGPPTL~LGPPPPPPPTL~`~LGGTGIIIIPPPTGGGGGGGGGGGGGGGGIIIL~````~GGGGGGTTGGGTB~~
~~BGGGTTGGFFL~```~LGTGTGGTGGPPPPPPPPPPPPGGGPPPPPPPPPFFPTPTPPPPGPGPPPPPPPPGL~``~LGTIIIIIPPPPPPPGL~~~~LLL~~~LIIIIL~``~LTGGGGGGGTTTTB~~
~~BGGGGGGGFFFL~~~LGGGGGGGGTGPPPPPPPPPPPGLLLGPPPPPPPGLLGPPPPPPPPPPPPPPPPPPGL~```~GGIIIIIPPGGPPGL~````~~~```~LIGGGL~~LGGGGGGGGGGTGTB~~
~~BGGGGGGGFFFFLLLGGGGGTGGGGGGTFFFFFFFFGL~~~LGGGGGGGL~~LFFPPPPPPPPPPPPPPPGGGL~~~LGGIIIIIPGLLTGL~```````~~``~LGGGGGLLTGGGGGTTGGTGFGB~~
~~BGGGGGTGLLFFFFGGGGFFGIIIIIGFFFFFFGFFL~```~LGTTGGGL~~LFFGPPPPPPPPPPPPPGLLGGLLLGPPPPPPPPP~~LGL~``````~LL~~LGPPPPPTGPPPPPPPPPPGGFGB~~
~~BGGGGTGL~~LFFFGGGGTTGIIIIIGGGGFFGTGGL~```~LGGGGGGGLLGFGTIIIIIIITGTGTGL~~LMIIIPPPPPPPPPJ~`~LL~````~~LGGLLGGPPPPPPPPPPPPPPPPGLLLGB~~
~~BTGGGGL~``~LGGGGGGGTGIIIIIGGGGTGTGGGL~``~LGGGGGGGGGGGGGTGIIIIIIIGGGGL~``~PPPPPPPPPPPPP~``~LGL~``~LLGPPGGLLGPPPPPPPPPPPPPPGL~~~LB~~
~~BGGGGGL~``~LGTGGGGTGIIIGGGGGGGTGGGGGL~~~LTGGGGGGGTGGGTGGGGGIIIITGTGGL~~~LGTGGGGGGGGGPGL~~LTPGL~~LGFGGGGL~~LGTGGGGGGGGGGTTG~```~B~~
~~BGGGGGGL~~LGGGGGGGTGIIIGGGGGGGGGGGGGGLLLGGGTGGGTTGTGGGGGGGGGGGGGGGGGGLLLGGGGGGGTGGGGPPGLLGPPPTLLFFFFGGL~``~LGGGGGGGTGGGGGGL~``~B~~
~~BGGGGGGGLLGGGGGGGGGGIIGGGGTGTGGGGGGGGTGGGGGGGTGGTGGGGTGGGGGGGGGTTGGGGGGGGGIGGTTGGGGGPPPGGGPPPTTFFFFFTL~```~LGGTGGGGTGGTGGGGL~`~B~~
~~BGGGGGGTGGGGGGGGGGGGFFFGGGTGGTGGGGGTGGGGGGGGGGGGGTGGGGGTTLLGGGGTGGGGTGGGGGLLLLLLGGGGPPPGGGPPPGGFFFFGGL~```~LGGTGGTTGGTGGGGGGL~LB~~
~~BGGGGGGGGTGTTFGGTGGGGFFGGGTGGGGGGGCGTGGGGGGTGGGTGGGGGGGGL~~LGTGGGGGGGGGGGL~~~~~~LGPPPPPGGGPPPGGFFFFGTL~``~LGTGGTGGGGGFGGGTGGFFFB~~
~~BGFGTTTGGGGGFFFFGIIIIFFFFGGGGTGTTCCCGGGGTGFFFFGGTGGGFFGL~`~LGGGGGTGGGFFFL~``````~LGPPPPGGGPPPGGGFFFGLL~~~~LGGGGGGTGGFFFGTGTFFFFB~~
~~BFFGTGGGGGFFFFFIIIIIIIFFGGGGGGGFCCCCCGGTGGFFFFGGGGFFFFGL~~LGGGFGFFFFFFFFL~``````~LTPPPPGGGPPPGGGGFFL~LLLLLTGGGTTGGGGFFFFTGGFFGGB~~
~~BFFFGGGGGFFFFFFGIIIIIIFFFGGIGGGFFCCCGGGGLLFFFFFFGGGFFFL~`~LTGGFFFFFGFFFFL~~~```~LGPPGGGGGGPPPGFFFFF~`~LTGGGGGTGGTTGFFFFGGGTGFGGB~~
~~BFFFFGGGGFFFFFFIIIIIIILLTTIIGGFFFFCGGGGL~~LFFFFTGTGFFFL~`~LGTGFFFFFGFGFFFLLL~~~LGPPPGTFFTGPPPTLLLFFL~LTGGTGTGGGGGGGGFFFFGGGTTGGB~~
~~BFFFFTTIIIIL~LIIIIIIGL~~LGGIGGGFFFFGGGL~``~LFTTTGGGGFFGL~LGGGGFFFFGGFFFIIIIILLLGPPPFGGFFGGPPGL~~~LFFGGTGTGGGGGTGTTGFFFFFTGGGGGGB~~
~~BFGGGGGIIIL~~LIIIIIIL~``~LGL~LGFFFFGTGL~```~LLLGGGGFFFFGGGGGGGGGGFGFFFFFFIIIIGGPPPFFFFFFGGPPGL~`~LFFGGTGGTGTGGGGTGFFFFFFFFTGGGGB~~
~~BFGGTGTIIIL~~LGIIIIIL~``~LL~`~GGFFGGFFTL~~~`~~~LLLGFFFGGGGGGGGGGGGGFFFFFIILLLGPPPGFFFFFFFGPPPGL~LFFGGGTGGGGGGGGGGTGFFFFTFGGGTGTB~~
~~BGGGGGLLIIGLLGGGIIITL~``~LL~~LGGGGGTFFGTLLL~```~~~LFFGGGTGTGGGGGTGFFFFFFIL~~~LGPTFFFFFFFFGPPPGGFFFGFGGTTTGGTFFGGGTGGFGTTGFFFGTTB~~
~~BGGGGL~~LGTTIGGGGIGTGL~~LIILLGGGGTGGGTGGGTGL~`````~FFFGGTTTGGGGGGGFFFFFFF~```~PPTFFFFFFFGTPPPGGFFFFFFGGGGTGFFFFGGGGGGGFGFFFFFGGB~~
~~BGGGL~``~LGGIIGGGGGGTGLLIIIIIGGGTGGGTGGTGGGL~````~LFLLLGGTGTGGGGGGGFFIGFGL~~~LGPGTFFFFFFFGPPPGGFFFFGGGGGFFFFFFFFGGGGGFFFFFFFFFGB~~
~~BGGGL~``~LIIIIIGGGGGGGGIIIIIGGGGGGGFFGTGGGGL~```~LGL~~~LTGTGGGTGGTGGFFFGGGLLLGPPGFFFFFFFGGPPPTGGGFTGGGGGFFFFFFFFFTGGGFFFFFFFFFGB~~
~~BGTGL~``~LGGGGGGGTGTTGGGGGIIGTLLLLFFFGTGTGGL~```~LGL~``~LGGGGGGGGGGGFGGGPPGTGPPPGFFFFFTPPPPPPGTGGGGGGTGGFFFFFFFFTTGGGGFFFFFPPPGB~~
~~BTTGL~``~LGGGGGGGGGTGTGTGGGGGL~~~~LFFGGTGTL~````~LFL~```~LTGTGGGGTGGFTGPPPGPGPPPGGFTGGGPDPPPPGTGGTGFGFFFFFFFFFFGTGGGGGGFFFFPPPGB~~
~~BGGTL~```~LGGGGGTGTGTGGGTGGTL~````~LGIIIIL~`~~~~LFFL~````~LGGGGGGGGFFFGPPTL~LGPPGGGTGTGPPPPPPTGGTGTFFFFFFFGFFGGGGTGGTGGGGFFPPPGB~~
~~BGGTGL~```~LGGGGFGGGGTGGGGTGL~````~LGIIII~`~LLLLFFFFL~~``~LTGGGGGGPPPPPPFL~`~LGPGGGGGTGPPPPPPGTGGGGFFFFFFFGGFFGGGGGGGGGGGGPPPPGB~~
~~BTTGTL~````~LFFFFTGGGGGTTGTGGL~~~~LTGTIIIL~LTFFFFFFFFLL~~LTGGGGGGTPPPPPPFL~~~LGPGGGGGGTPPPPPPGTGGGGGFFFFFGGGFFFGGGGGGGGGTPPPPPTB~~
~~BGGGGGL~````~GTTGGGGGGTGTTGGTGLLLLGGIIIITGGGGGFFFFFFFTGLLGGGGGGGTGPPPPPPPGLLLGPPTTGGGGPPPPPPPGTGGGGTFFGTLLTGFFFFGGGGGGGGGPPPPPGB~~
~~BGGGTGL~```~LGGGGGGGGGGGGGGGGTGGGGGGIIIIGTGGGGTFGGTPPPGTTGFFGGGGGGGGGGGGGGGGTPPPGGGTGGPPGPGPPGGGGFFFGGGL~~LGGFFFGGGGGPPPPPPPPGGB~~
~~BFTGTGGL~`~LGGGTGGGTGGGGGGGGTGGGGGGIIIIIGGGGGTGGGGGPDPGTFFFFGGGGGGGGGGGGGGGGGPPPGGGTGGPGL~LGPGGGGFFFTGGL~`~LFFFFFTGGPPPPPPPPGGGB~~
~~BFFFTFTGL~LGGTTGTGGGGGGGGGTGGGGGGGGIIIIITGGGGGGTGGGPPPGFFFFFGGGGGGGGGGGGGGGPPPPPGGTGTGPP~`~PPGGGFFFFFGGL~`~LFFFFPPPPPPPPPPPPGGGB~~
~~BFFFFFFTGGGGTGGGGGGGGGGGGGGGGGGGTTIIIIIGGGGGGGTGGTGPPPFFFFFFGGGGGGGGGGGGGGGPPPPPGGGTGTPGL~LGPGTTFFFFPPPFL~LGPPPPPPPPPPPPGFFGGGTB~~
~~BFFFFFGGGGGTGGTGGGGGTGGGTGGGGGGGGGGGGGGGGGGFGGGGGGGPPPFFFFFFGGGGGGGGGGGGGGGPPPPPGGGGGTPPGGGPPGTTGGPPPPPPGPGPPPPPPPPPPPPFFFFFGTGB~~
~~BFFFFFGGGTTGGTGGGTTGGTGGGGGGGGGGGGGGGGGGGGFFGGGGGGGPPPIIIIIFGGGGGGGGGGGGGGGPPPGGGPPPPPPPPTPPPGGGGPPPPPPPPPPPPPPPPPPGGTTGFFFGTGGB~~
~~BGGGTGGGGGGGGGTGGGGGGGTTGGGGGGGGGGGGGGGGGGFFGGGGGGGPPPIIIGFFGGGGGGGGGGGGGGGPPGGGPPPGTPPPPGPPPGGGPPPPPPPFGGGTTGGGGGGGTGGFFFFFFFGB~~
~~BGGGGGGGGGTGGGGGGGGGGGGGTGGGGGGGGGGGGGGGGFFFGGGTGGGPPPIIIGFFGGGGGGGSGGGGGGGPPGTGPPGLLGPPPGPPPGGGPPPPPFFFFGGGGGGGTGGGTGFFFFFFGGGB~~
~~BGGGGGGGGGGGGGGGGGGGGGGGTGGGGGGGGGGGGGGGGGGGGGGGGGTPPPIIIGGFGGGGGGGGGGGGGGGPPGGGPGL~~LGGGGPPPGTPPPPPFFFFLLLLGGGGTGTGGTGTFFTGGGGB~~
~~BGTTGGGTGTGGTGGGGGTGGTGGGGGGGGGGGGGGGGGGGGGTGGGTGGGPPPIIGTTFGGGGGGGGGGGGGGGPPGGGPGL~`~GFFFPPPGPPPPPFFFFL~~~~LGGGGGGGGGGGGGGGGGGB~~
~~BGPPPPPPPPPPPPPPPPPPPPPPPPGGGGGGGGGGGGGGGGTGGGGGTGTPPPIIGGGGGGGGGGGGGGGGGGGPPGGGPGL~~LGFFFPPPGPPPPPFFFL~````~LGGTGGGGGGGGGGGGGGB~~
~~BTPPPPPPPPPPPPPPPPPPPPPPPPGGGGGGGSGGGGGGGGGGTGGGGTGPPPIGGGGGGGGGGGGGGGGGGGGPPGTGPPGLLFFFFFPPPGPPPPFFFF~`````~LGTGGGGGGGGGGGGGGGB~~
~~BGPPPPPPPPPPPPPPPPPPPPPPPPGGGGGGGGGGGGGGGGTTGTGGGGGPPPPPPPPPGGGGGGGGGGGGGGGPPTGGPPPFFFPPPPPPPGPPPGFFFIL~~~~~LGGGGGGGGGGGGGGGGGGB~~
~~BTGGGGGGGGGGGGGTGGGGGTGGGGGGGGGGGGGGGGGGGTGGGGTGTGTPPPPPPPPPGGGGGGGGGGGGGGGPPGTGPPPPFFPPPPPPPTPPPGGFFIILLLLLGGGGTGGGGGGGGGGGGGGB~~
~~BGGGGGGGGGGGGGGFFFGTTGGTTGGGGGGGGGGGGGGGGGGGGGGGGGGGGGGGGGGPGGGGGGGGGGGGGGGPPGGGGPPPFFPPPPPPPGPPPGGIIIGGGGGGTGGGTGGGGGGGGGGGGGGB~~
~~BGGTTGTGGGGGTGFFFFFGGGGGGGGGGGGGGGGGGGGGGFFGGGGGGGGGGGGGGGGPPPPPPPPPPPPPPPPPPGGGGPPPFFPDPGGGGGPPPGGGTGGGGGGGGGGGGGGGGGGGGGGGGGGB~~
~~BTGGGGGGGGGGGGFFFFFGGGGGGGGGGGGGGGGGGGGGGGFFGGGGGGGGGGGGGGGPPPPPPPPPPPPPPPPPPGGGGPPPGFPPPGGGGGPPPTGGTGGGGTGTGGTGGGGGGGGGSGGGGGGB~~
~~BGGGGTGGTGGGTTFFFFFTGGGGGGGGGGGGGGGGGGGGGFFFGGGGGGGGGGGGGGGGTGGGGGGGGGFFFFFFGGGGTPPPPPPPPPPPPPPPPGGGGGTGGTGTGGGTGGGGGGGGGGGGGGGB~~
~~BGGGGGGTGGGGFFFFFFGGGTGGGTGGGGGGGGGGGGGGGFFFGGGGGGGGGGGGGGGTTGGGTTGGGGTFFFFFGGTGGPPPPPPPPPPPPPPPPGGTTGGGFGGGGGGGTGGGGGGGGGGGGGGB~~
~~BGTGTGGTGGGGTFFGGTGGGGTGGGGGGGGGGTGGGGGGFFFFGGGGGGGGGGGGGGGGGGGGGGGGTGGGFFFFFFGFFPPPPPPPPPPPPPPPPGTGGGGGFGGGGGGGGGGGGGGGGGGGGGGB~~
~~BGPPPPPPPPPPPPPPPPPPPPPPPPPPPPPPPPPPPPPPPPPPGGGGGGGGGGGGGGGGGGGGFGTTGGGFFFFFFFFFFFFFGGGGGHGTGGGGGGTTTGTGFGGGGTGGGGGGGGGGGGGGGGGB~~
~~~BGPPPPPPPPPPPPPPPPPPPPPPPPPPPPPPPPPPPPPPPPPGGGGGGGSGGGGGGGGTFFFFFGGGTGGFFFFFFFFFFFGGGGGGGGGGGGGTTGGGGGFGGGTTGGTGGGGGGGGGGGGGGGB~~
~~~~BGPPPPPPPPPPPPPPPPPPPPPPPPPPPPPPPPPPPPPPPPGGGGGGGGGGGGGGGFGFFFFFGGGGGGFFFFFFFFFFGGGTGGGGGTGGGGGGGTGFFFFFGGTGGGTGGGGGGGGGGGGGGB~~
~~~`~BGGGGTTGGGTGFFFFGGGGGTGGGGTGGGGGGGGGGGGGGGGGGGGGGGGGGGGGFFGFFFLLGGGGTGTFFFFFFFGGGGGGTGGGTGGGGGGGGFFFFFFFGTGTGTGGGGGGGGGGGGGGB~~
~~~`~BTGGGGGGGTGGGFFFPPPPPPPPPPPPPPPPPPGGGGGGGGGGGGGGGGGGGGGGFFGFFL~~LGGGTTGTFFFFFGGTGGTGTGTGGGGGGGFGGFFFFFFFGGGGGTGGGGTGPPPPPPPIB~~
~~~~BTTGTGTGGTGGGFFFFPPPPPPPPPPPPPPPPPPGGGLLGGGGGGGGGGGGGGGGGFFFGL~`~LGFGGGGGFFFFGGGTGGGGGGGGGGTGFFFGGFFFFFFGGGGGGFGGGGTGPPPPPPPIB~~
~~~BGGGGGGGGGGGGGGFGTPPPPPPPPPPPPPPPPPPGGL~~LGGGGGGGGGGGGGGGGTGFGL~~LTGGGGTGGGTFFFGGGGPPPPPPPPPGGFFFGGGFFFFFFTTFFFFFGTGGGPPPPPPPIB~~
~~BGGGGTGTTTGTTGGGGGGPPPGGTGGGGPPPFFPPPGL~``~LGGGGGGGGGGGGGGGGGFG~~LGPPPPPPPPPPPPPPPTGPPPPPPPPPGFFFFFGFFFGGGGTGFFFFFFTFFGGGGTIIMIB~~
~~BFGGGGGGGTGGGGGGGGGPPPGGTGGGTPDPFFPPTL~```~LGGGGGGGGGGGGGGGGGPGLLGPPPPPPPPPPPPPPDPPPPPPPPPPPPPTFFFFFGGGGGTGFFFFFFFFFFFFGGGGTIIIB~~
~~BFFGGGGGGGGGGGGGGGTPPPTGGGGGGPPPFFFPGL~``~LGGGGFGGGGGGGGGGGGPPPGGPPPPPPPPPPPPPPPPPPPPPPPPPPPPPFFFFFTGGGGGGGGGGGFFFFFTGGGGGTGGIIB~~
~~BFFFGGGGGGFFGTTGTGGPDPGGGGGGGPPPFLLGPGL~~LFFFFFFFGGFGGGTGGPPPPPPPPPTGGGPPPPPPPPPPPPPPPPPDPPPPPFFFFFFGGGTTGGGTGTFFFGTGGGTGGGGGGTB~~
~~BFFFFGGLLLFFFFFGGGGPPPGGGTGGFPPPF~~PPGGLLFFFFFFFFFFFFGTPPPPPPPPPPPPPPPPPPPPPPPPPPPPPPTTPPPGPPPFFFFFGGGGGTGTGTTGFFFGTTTGFFFTGGGGB~~
~~BGGFFFL~~~LFFFGTGGGGTGGGGGTTFPPPFLLGPTGGGFFFFFFFFFFFGGTPPPPPPPPPPPPPPPPPPPPPPPPPPGPGGGGPPPGPPPPFFGFTGGGGGLLGGGGFFGGGGGGGFFFGGGGB~~
~~BGFFFL~```~LGGGGGGGGGTGGGGFFFPPPFGGPPGGFGGFTGGFFGFGGTGTPPPPPPPPPPPPPPPPPPPGTGTTTGL~LLGTPPPGPPGDLLGFGGGGGG~~LGGTGGGGGGGGGFFFFGGGB~~
~~BFFFFL~````~LGGGGGGTGGFGGTGFFPPPGGPPPGFFGTFTGFFGFFGGGGGPPPGPPPPPPPPGTGGGTGGGGGTGG~`~~LGPPPGPGLL~~LGGGGTGGL~LGGGGGGGGGGTTTFFFFGTB~~
~~BFFFFL~````~LGTTGGGGTGFFTGGFFPPPGGPPPGGFFGGTGFFFFGGGGGGPPPGPPPPPPPFFGTGGGGGFGTTGGL~``~GPPPGGL~~``~LGTGGGGIIGGTGGGGGTGFFTGGFFFFGB~~
~~BFFFL~`````~LGGGGGGGGGFFFFGFFPPPGGPPPGFFFGGGGFFFFGGGTGGPPPGPPPPPFFFFGTGGGGGFGGGGGTL~~LGPPPGL~````~LGTGGGGIIIIGGGGGGGGFFFFGGFFGGB~~
~~BFFFL~`````~LTTTGGGFFFFFFFFFFPPPGGPPPGGTFGGGGFFFFFFGGGGPPPTGGGGGFFFFFGGGGGFFGGGGTGGLLGTPPPGL~``~~LGGGGGGGIIIIGGTGGGGFFFFFGGGFTGB~~
~~BFFFFL~~~~~LTTGGGGGTPPPPPPPPPPPPGGPPPGGTGGTGGTFFFGFGGGGPPPGGGGGGFFFFGGTGFFFFFBGGGGGGGTTPPPGGL~~LLGGGGGGGGIIIIIGTGGGGFFFFFFTGFGGB~~
~~BFFFFFLLLLLGPPPPPPPPPPGGPPPPPPPPGGPPPGGGGGGGTGFFFGTTGTGPPPGGGGGGGBBGGGGFFFFFB~BGGTTGTGGPPPPPGLLGGPPGTGGGTIIIIIIGGGGGFFFFTTGGTGGB~~
~~BCFFFFGGGGGPPPPPPPPPPMBBGPPPPPPPGGPPPGGGGBBBGGFFFFFGGTGPPPGGGGGGB~~BGGGGGGFB~`~BGTTGGTTPPPPPPGGPPPPGGTGGGIIIIIGGGCGGTFGTGGGGGBGB~~
~~BCCGGFPPPPPPPPPPPPPPGB~~BGGGGGGGGGPPPGGGB~~~BGTFFFFFGGGPPPTTGGTB~``~BGTGGGB~```~BGGGGGGPPPPPPPPPPPPGTGGGTIIIGTTGCCCGGGTGGGGGB~BB~~
~~BCCCGTHGTTGGGGGGGGTGB~``~BGGGGGGTGGGGGGB~```~BGFFFFFGGGGGTGGGGGB~```~BBGGGB~```~BTGGGTTGFFFFFGTGGGGGGGGTTGGGGGGCCCCCGGGTGGGB~`~B~~
~~JBBBBBBBBBBBBBBBBBBB~~~~BBBBBBBBBBBBBBBB~~~~~~BBBBBBBBBBBBBBBBBBB~~~~~~BBB~~~~~~BBBBBBBBBBBBBBBBBBBBBBBBBBBBBBBBBBBBBBBBBBBB~~BJ~~
~~~~~~~~~~~~~~~~~~~~~~~~~~~~~~~~~~~~~~~~~~~~~~~~~~~~~~~~~~~~~~~~~~~~~~~~~~~~~~~~~~~~~~~~~~~~~~~~~~~~~~~~~~~~~~~~~~~~~~~~~~~~~~~~~~~~
~~~~~~~~~~~~~~~~~~~~~~~~~~~~~~~~~~~~~~~~~~~~~~~~~~~~~~~~~~~~~~~~~~~~~~~~~~~~~~~~~~~~~~~~~~~~~~~~~~~~~~~~~~~~~~~~~~~~~~~~~~~~~~~~~~~~
