````````````````````````````````````````````````````````````````````````````````````````````````````````````````````````````````````
``~~~~~~~~~~~~~~~~~~~~~~~~~~~~~~~~~~~~~~~~~~~~~~~~~~~~~````~~~~~~~~~~~~~~~~~~~~~~~~~~~~~~~~~~~~~~~~~~~~~~~~~~~~~~~~~~~~~~~~~~~~~~~``
`~BBBBBBBBBBBBBBBBBBBBBBBBBBBBBBBBBBBBBBBBBBBBBBBBBBBBB~``~BBBBBBBBBBBBBBBBBBBBBBBBBBBBBBBBBBBBBBBBBBBBBBBBBBBBBBBBBBBBBBBBBBBBBBB~`
`~BGGGGGPPPPPPPPPPPPPPPPPPPPPGGLGGTPPPPPPPPPPPPPPPFGGGGB~~BBGGGGPPPPGGGGGGPPPPPPPPPPPPPPPPPPPPPPPPPPPPGGPGGGTPPPPPPPPPPPPPPPGGGGGB~`
`~BGJPGPPPPPPPPPPPPPPPPPPPPPFGLLLGGFPPPPPPPPPPPPPPPGGTPBBBGGGGTPPPPGGLLLLGGPPPPPPPPPPPPPPPPPPPPPPPPPPGGGLLLLGGPPPPPPPPPPPPPPPGGJTB~`
`~BFGGPPPPPPPPPPPPPGTGGTGGGGFGL~LLFFGIIIIIIIIIIGGPPPTPPPTTPGPGPPPPGGGL~~~LGTFGGTGGGGGGTTIIGGTGGGGGGTGGGGL~~LGTPPPPPPPPPPPPPPPPPGGB~`
`~BFFGGPPPMFFPPPGGTGGGGGGIIIIL~`~LFFGGGGGIIIIIIGGGPPPPPPPPPPPPPPGGGGL~``~LGGFFFGGTGGGGIIIGGGGTTTGTGGTGGL~``~LGGHGTGGGGGTGGGGGGMGGB~`
`~BFFFGTPPFFFPPPGGGGTGGGIIIIIL~``~LFFGTGTTIIIIIGGGGGGTIIIFFFGGTGGGGGL~``~LFFFFFFGGGGTIIIIGTGGGTGGGGGGGTL~``~LGGGGGGGTGGGGGGGGGTGGB~`
`~BBBBBGGPFFFPPPGGGGGTGGIIIIIL~``~LFFGGGTGGFGGTGTGGTGGIIIFFFGGGTGGGGL~``~LGGFGGFGGGGGIIIIGGGTGGGTGGGGGL~``~LLGGTTGTGTGGGGGGGGGGGGB~`
``~~~~BGPPFFFPPPGGTGTGGIIIIIIL~``~LGGGGTTGGGTGLLLGGGGTIIIFFFGGGGGGGGL~``~LGGFGGGGGGTGIIIIGGGGGGGGGGGGTL~`~LFFFFGGGGGGGGGGGGGGGGGFB~`
``````~BGPFFFPPPGGGGTGIIIIIIIIL~~LLGTGGGGGGTGL~~LGGTGGIIFFFFFGFTGGGGL~``~LGTTGTGGGTTTIIIGGTGGGGGTGTTGTL~`~LFFFFGGGGGGGGTGTGGGGGFFB~`
``````~BTPFFFPPPPGGGTGIIIIGGGGLLLTGGTGGGGGGGGL~`~LGGGIIGFFFFGFFGGTTTGL~~LLFFGGGTGGGGGIIIGGGGGGGGGGGGGGL~`~LFGIIGGGGGGGGGGGGGGGFFFB~`
``````~BGPFFFPPPPPTGGGGGGGTGGGGGGGGGTGGGGGGGGL~`~LGGGIITFFFFFTFFGGGGGLLLGGFFFGGGGGGGIIIITGGGGGGGGGGGGGGL~LLGIIIITGGGFGGGGGFFFFTFFB~`
`````~BBGPFFFPPPPPPGGGFFFGGGGGGGGGGGGGGGGLLLLGL~LLTGGGGGFGGGGGFGTGGGGGGGGFFFFFTGGGTIIIIIIGGGGIIIGGGTGGGLLGGGIIIIIGGGFGGTTFFFFFGGFB~`
````~BBGGPFFFFPPPPPGGGFFFGGTGTGGGGGGGGGGGL~~LLGLTGGTGLLLGGGGGGGGGTGGGGGGGFFFFFGGGGTIIIIIGFGGGIIIGGGGGGGTGTGGIIGIIGFFFFGGTGFGFFTGGB~`
``~~BBGGPPFGFFFPPPPTGGFFFFFTTGGGGLLLLLLLL~``~LLTGGTGGL~~LGGFGGGGGGGGGGGGGFFFFGGGGGGIIIIIGFFGIIITGGGGGLLLLLGGIIGIIFFFFFFGGGGFFFGGGB~`
`~BBGGGPPPGGGFFFPPPTGGFFFFGGGTGTL~~~~~~~~````~LGFGGGGGL~LGGFGGGGGTTGGGGTGGFFFFGGGTFFGGFFFFFGGTTGTGGLL~~~~LGGGGTFFFFFFFFFGGTGFGGTGB~`
`~BGGGGPPPGGGFFFPPPPGGFFFFFFGGTGL~````````````~LFFFGGGLLGTGFFFGGGTGGGTTGGGGGTGGGGFFFFGGFFFFFGGGTTTL~~````~LGGGGGGFFFFFFGGGGGGGGGTB~`
`~BGTGHPPPTGFFFFPPPPPGFFFFFGGGGGL~~``````~~~``~LFFFFFGGGTGTTFFGGGGTGTGGGGGGGGGGGGFGFTGGGLLLGGTGFFGL~`````~LGGGGGGFFFFFGGGGGGGGGBBB~`
`~BGGGGPPTGFFFFFPPPPPGTFFFGGGGGGGLL~~~~~~LLL~`~LFFFFGTGGGGGGGFGTGGGGGGGGGGGGGGGGGGTFGGGTL~~LGGGFFTL~``````~LGGGGGTTFGGGTGGTGGGGB~~``
`~BGGGGGTGLLLGFFFPPPPPFFFFFTGGGGGGTLLLLLLGGGL~LLFFGFGTGGGGFFGGTCGTGGGGGGTGTGGTTGGGGGGGLL~`~LGGGTGTGL~~````~LGGGGGGGGGGTGGGTGGGB~````
`~BBBBGPGL~~~LGFGGPPPPGFFFFGTGGGGGGTGGTGGGGGLLFGTFTTTTTGGGGFFGCCCGGGGGGGGGGGGGGGGTGLLL~~``~LTGTTGGGLLL~~~~LLGGGGGGTGTGTGGTGGTGB~````
``~~~~BGGL~`~LGTTGPPPPTGFTGGGGGGGGGGGGTGGGGGGGFFFFTTGGGGGTFFFCCCCCGGGGGGGGGGGTGGTGGL~~````~LGGGGTGGIIGLLLLGGGTGTTLLLLLGGTGGGGTB~````
`````~BGGGL~~LGGGGGPPGGLLLGGGFGFGGGGTGTGGGGGGFFFGGGGGTGGTGTFGGCCCGGTGTGGGGTGTGGGGGL~`~~~``~LGTGGIIIIITGGGGGGTTGGGL~~~LGGGGGGTTGB~~``
`````~BTTGLL~LGGGGGPPGL~~LLGGFGFGGLLLGGGGTGTGGGFGTGGGTGGGGGTGGGCGGGGGGGGGGGGTGGGGGL~~LLL~~LLGGGTIIIIIGIILLLLGGGGGGL~LLFFGGGGGGGBBB~`
`````~BGPGGL~~LGGTGTPGL~`~LGFFFFGL~~~LFFGGGGTGGTTGGGGGTGGTGGGGGGGGGGGGGLLLGGGGGTGGGLLTGGLLGGGGGIIIIIIIIIL~~LFFGGGGLLGGFFFFTGGGGTGB~`
``~~~BBGGGGL~~LGGTGGPGGL~LLTFFFFFL~`~LLFFGGGGGTGGGGTGGGGTGGTTGGGGGGGGGL~~~LGGGGGGGGGGGGGGGGGLLLLGIIIIIIIGLLGFFGGGGGGGFFFFFFGGGGGTB~`
`~BBBGGPPGTL~LLGTGGGPGGLLGGGFGFFL~```~LGGGGGGFGGGTTGGGGGGGGGGGGGGGGTGGL~`~LGGGGGGGGGGGGGGGGLL~~LGIIIIIIIIGGTFFFGGGTGGGFFFFTTGGGGTB~`
`~BGGGGGGGGGLLGGGGGGGTGPGGFFFFFFL~````~LLLLLGFGGGGGGGGGGGTGGTTTTGGGGGGL~~~LGGGGGGGGGGGGGGGGL~``~LIIGGIIIGGGGFGGGGTGTGTGGFGGGGTGGGB~`
`~BGGGGGGGGGGGGGGGLLLLGGPGFFFTFFGL~``~`~~~~LFFFGGGGGGTGGGGGGGGTGGGGGTGGLLLGGGGGGGGGGGGGGGFGGL~`~LIGGGGTGGGGGGGGGGGTTGGTGGTGGGTGGIB~`
`~BGGGGGGGGGGGGGGFL~~LTPPFFFFGGFGLL~~L~````~LFGGGGGGGTGGGGGFGGGGGFFGGGTGTTGGGGGGGGGGGGGGGFFGLL~LLIGGTTGGGGGGGGGGGGGGGGGTGGGGGGGGIB~`
`~BGGGGGGGGGGGGGGL~``~LGPFFFGGGGGGGLLLL~```~LFFGGGGGGGGGGFFFFGGGGFFFGGGGGGGGGGGGGGGGGGGGGFGGGGLLGGGGGGTGGGGGGGGGGGGGGFGTGTGGGGGIIB~`
`~BGGGGGGGGGGGGGGL~``~LGPGGFGFFFGGTTGL~````~LFFFGGGTGGGGGTGFFGGGGFFFFGGTGGGGGGGGGGGGGGGGGFFGGGGGGGGTGGGGGTGTTGGGGFGFFFFFGGGGGTGGTB~`
`~BGGGGGGGGGGGGGGL~``~LGPGTGGGGGTGGGTL~``~~LLFFGGGGGGTTTGGGGFGGGGFFFFFGGGGGGGGGGGSGGGGGGGFFFGTGGGGGTGGGGGFGGGGGTFFFFFFFFTGGGGGTGTB~`
`~BGGGGGGGGGGGGGGGL~`~LGPTGTGGGGGGIGGGL~~LLFFFFGGGGTGGGGGGGIGGTGGFGFFFFFTFGGGGGGGGGGGGGGGFFFFGGGTGGGGGGFFFFGGGGGGFFFFFFFGGGGTGGGTB~`
`~BGGGGGGSGGGGGGGGLL~LLPPGTGGGGGGIIIGILLLGGFGFFFGGGGGGGGGIIIIIGGTTGFTFGGTGGGGGGGGGGGGGGGGFFFFFFGGTGTGGFFFFFGGTTTGFFFFFFFGTGGGGGTGB~`
`~BGGGGGGGGGGGGGGGGFLLGGPFFGGGGIIIIIIIIIIGGFFFFFGGTGTTGGIIIIIIIIGTTGTGGTGGGGGGGGGGGGGGGGGFFFFTGGGGGGGFFFFFFTTGGTGFFFFGFFGGGGGGTGGB~`
`~BGGGGGGGGGGGGGGGGFFFFPPFFFFIIIIIIIIIIIIIFFFFGFGGGGGGGGIIIIIIIIITGTGGGGGGGGGGGGGGGGGGGGGFFFFGGTGGGGGFFFFFFFGGGGGTFFGGFGGGGTGGGTGB~`
`~BGGGGGGGGGGGGGGGGFFFPPPFFFFIIIIIIIIIIIIIIFFFGGGGGGGGGGIIIIIIIIIIGGGTGGTGGGGGGGGGGGGGGGGGGGGGGTTGGGGFFFFFFTGGTGGGGGFFFFGGGGTGGTGB~`
`~BGGGGGGGGGGGGGGGTGGGPPPFFFFIIIIIGGIIIIIIIFFFGGGGGGGGTGIIIIIIIIIIIITGGGTGGGGGGGGGGGGGGGGGTTGGGGFGGGFFFFFFFGGGGTGGGGFFFFGGGGGGGGGB~`
`~BGGGGGGGGGGGGGGTGGGGPPPFFFFFTIIIGGGGIIIIGGLLLLLLGGGGTGIIIIIGGGIIIITGGGGGGGGGGGGGGGLLLLLGGGGFFFFGGGFFGFTFGGGTGGGGGGFFFFFTGGGGCTGB~`
`~BGGGGGGGGGGGGGGGTGTTPPPPPPPGGGGGGGGTGGGGGL~~~~~LGGGGGGGIIIIGGGIIIIGGGGGGGTTGPPPPPGL~~~LGGGGGFFFFGTGGGGTGGGGGGGGGGGFFFGTGTTGCCCGB~`
`~BGGGGGGGGGGGGGGGGGGGTTTPGPPGGGGTGGGTGTTGGL~````~LGGGGGGIIIIGGGIIIIGGGGGGGGTGPPPPGL~```~LGTGGGFFFFTTGGGGGGGGGGGGTGGFFFFGGGGCCCCGB~`
`~BGFFFFFFFFGGTGGGGGLLLLGGGGPGGGGGGGGGGGGGGGL~```~LGGGGGGIIIIGGGGGIPPPPPPPPPPPPPPPGL~```~LGGGGGGGGGGGGGGGGGFFFTGGTTGFFFGGGTGGCCCGB~`
`~BTFFFFFFFFGTTTGGGGL~~LLGGPPTGGGGGGGGGGGGGGL~```~LGGGTGGGGTGGGTGGTPPGPLPGPPPPPPPGGL~``~LTGGGGGGGGGGGGGGGGGFFFTGGGTGFFFGGGGGGGCTGB~`
`~BGLLLFFFFGGGTGTGGL~``~LLPPPGGGGGGGGGGGGGGGGL~~~LLGGGGGGGGGTGGGGGGPGGLLLGGPPPPPPGGL~``~LGGTGGGGGGGGGGGGGGGFFFFGGGGGGTFGGGGGFFGTGB~`
`~BL~~LFFFFFGGGGGTGL~```~LLPPGGGGGGGGGGGGGGGGLLLLGGGGGGGGGGGGGGGGGGPGLL~LLGTGGGGTTTGL~~LLGGGGGGGGGGGGGGGGGGFFFFFGGGTGFFGGGGGTTTGGB~`
`~BG~LLFFFFGGGGGTGL~`````~LGPGGGGGGGGGGGGGGGGTGGGGTGLLLGGGGGGTGGGGPPTL~`~LGGTGGGGGGGLLLTGGTGGGGGGGGGGGGGGGGFFFFFFGGGGFFGGGTGGGGGGB~`
`~BGLLGGFFFFGGGGGGL~``~~~LLGPGGGGGGGGGGGGGGGGTGTGGGLL~~LGGTTGTGGGPPPGGL~LLGTGGGGGGGGGGGGGGGGGGGGGGGGGGGGGGGFFFFFGGTGTGGGGGGTTGFGGB~`
`~BGGGGGFFFFGGGGGTL~~~LLLFGGPPGGGGGGGGGGGGGGGGTGGGGL~`~LGGGGGTGPPPPPGGLLFGGPPPPPPPPPPPPPPPPPGGGGGGGGGGGGGGGFGFFFFFTGGGGGTGGGGFFFFB~`
`~BFGFGGGFFFGGGGGTGLLLGFFFGPPPGGGGGGGSGGGGGGGGGGGTGGL~LLGTGPPPPPPPPPPGPTPGPPPPPPPPPPPPPPPPPPGGGGGGGSGGGGGGGGGFFFGFFGGGGGGGGFFFFFFB~`
`~BFFFGGTGTGGGGGGGGFFFFFFFPPPPGGGGGGGGGGGGGGGGGGGTGGLLGGTPPPPPPPPPPPPPPPPPPPPPPPPPPPPPPPPPPPGGGGGGGGGGGGGGGGGGTTFFFFGGGTGGTGFFFFTB~`
`~BFFFFGGTFFFFGGGGGFFFFFFFFFPPGGGGGGGGGGGGGGGTGGGFGTPTPTPPPPPPPPPPIIIIIIIIGGFFFFFFFTGGGGTFFFGGGGGGGGGGGGGGGTGGGGGFFFGGGGGGGGGFFFFB~`
`~BFFFFGTGGGGGTGGGFFFFFFFFFFPPGGGGGGGGGGGGGGGFFFFFTPPPPPPPPPPPGGGGTTGIIIIIIGFFFFFFFGGGGFFFFFGGGGGGGGGGGGGGGGTGGGGFFGGGGGGGGGGGFFGB~`
`~BFFFGGGTTTGLLLLGGGFFFFFFFFPPGGGGGGGGGGGGGGGFFFFFGPPPPPPPTGTGGGLLLGGGIIIGGFFFFFFTFTTGGFFFFFGGGGGGGGGGGGGGGGTGTTGGGGGGGGGGGGGGFTGB~`
`~BFFGTTGTTGGL~~LLGLLLLGFFFFPPGGGGGGGGGGGGGGGFFFFFMPPPTGGLTGTGTL~~LLTGGFFFFGFFFFFGTGGIIILFFFGGGGGGGGGGGGGGGGGGGGGGGGGGGGGTTGGTGTGB~`
`~BFGTTTGGTGL~``~LLL~~LGFFFFPPGGGGGGGGGGGGGGGFFFFFFPPGGGLLGGGGGL~`~LGFTFFFGGLLLLGTGGGGILLLGFGGGGGGGGGGGGGGGGGGGGLLLLGGGGGGGGGTTTGB~`
`~BGTGTGTGGGL~```~L~``~LFFFFPPGGGGGGGGGGGGGGGPFFFFGPPGGLL~LGGGGL~~LLFFFFFFFGL~~LGGGIGILL~LGGGGGGLLLLLLGGLLLGTGGGL~~LGGGGGGGGTGGTGB~`
`~BTGTGGTGTGL~````~```~LFFFFPPPPPPPPPPPPPPPPPPPPFFGPPPGL~~LGTGGGLLGGFFFFFFGL~``~LGIIILL~`~LGGGGTL~~~~~LL~~LGGTGL~``~LGGGGGFGGGGGGB~`
`~BGTGGGGGGGL~``~~~~``~LFFFFPPPPPPPPPPPTGGTGGGPPFGGPPGL~`~LGGPGTGGGGFFGFFGGL~``~LGIIIL~``~LLLLLL~`````~~``~LGFGL~``~LGGGGGFFGGGGGB~`
`~BTGGGGLLLL~``~LLLL~~LLFFFFFFFFFFFGPPTGLLLLLGTPPGTPPGL~`~LTGPDPPPPPIGLLLLGL~``~LGGIL~````~~~~~~``````~~~`~LGFFGL~~LLGGGGGFFFGFFFB~`
`~BTTGGLL~~~``~LGTGFLLTGFFFFFFFFFFFFGTGGL~~~LGPPPPTPPTL~~LGIIPPPPPPPIIL~~LGGL~~LLGIIL~````````````~~~~LLL~LLGFFGLLLGGTGGGGGFFFBBBB~`
`~BGGGGL~`````~LGGGFFFGGGFGGFGFFFFFGTGGL~```~LGPPPPPPTL~~LGIIIIIIPPPIL~``~LTLLLGGGGGGL~``````````~LLLLGGTLLGGGFFFFGGGGGGGGGFFBB~~B~`
`~BGGFL~``````~LTGGGFGGTGGGTGGFFFFFGGTGL~```~LGPPPPPPGGLLGGIIIIIIIPPIL~``~LGGGGGGGGGGLL~````````~LLGGGGGGGLLLLGFFFGGGGGGTGGGGB~`~~``
`~BFFFL~`````~LLGGTGGTTGGGGTGGTFGGGGGTGL~`~~LLGPPPPPPPGGGGGGPPPPPPPPIL~``~LGGTTTGTGGGGGL~~~~~~~~LLGGGGGGGL~~~LGFFGGGGGGGGGTGGGB~BB~`
`~BFFFGL~~~~~LLGGGTGTGGGGGTGGGGFGGGGTTGGL~LLTGPPPPPPPPPPPPPPPPPPPPPPIGL~~LLGGLLLGGGGGTTLLLLLLLLLGGGGTGGGL~```~LGGGTGGGGGTGGTGGBBGB~`
`~BTFFGLLLLLLGGGGTGGGGGGGGGGTGGGGGTTTGGGLLGGGGGPPPPPJPPPPPPTGLGGGPPPIGLLLTGTLL~~LLLGGTGGIIIFGGGGGGTGGGGGL~```~LGGTTGTGGGTGGGGGGTGB~`
`~BGGFGFFFGTGGGGGGGGGGGGGGGGGIGGGGGGGGGGPGGPPTPPPPPPPPPPPPGGLLLGTPPPIIGGGGTLL~``~~~LGGGGFFFFFTGTTGGGGGGLL~``~LLGGGGGTGGGTGGGGGGGGB~`
`~BGFFFGGGTTGTGGGTFFGGGGGGTGIITGGGTGGGPPPPPPPPPPPPPPPPPPPPPGL~LGGPPPIGGGGGLL~`````~LGGGGGFFGGGTGGTTTGGLL~``~LFFFFTGGGGGGGTGGGGGGGB~`
`~BGFFFFFTFGGGTGGGFFFTGGGGGGIIIGGGTTGPPPPPGGLGTGPPPGPPPPPPGL~`~LGPPPGGGGGLL~``````~LGGGGGGGGGTGGTGGTGLL~```~LFFFFGGGTGGGTGGGTGGGGB~`
`~BGFFFFFGGGTGGGFFFFFFGGGGGGIIIGGGGFFPPPPGGLLLGTPPPGGGGTGPTL~`~LTPPPGGGGGL~``````~LTGGFGGGGGTTTGGGGGLL~````~LFGFFGGGGGGGGGTGTGGGGB~`
`~BGFFFFTGGGGGGGFFFFFFTGGLGIIIGTTGFFFPPPPTGL~LGGTPPGGGTGGPPGL~LLGPDPTGGGGGL~`````~LGGFFFTGGGTGGGTGGGL~`````~LGFFFFGGGGGGGGTGGGGTGB~`
`~BGTGGGTTGGTGGFFFFFFGGFGLLGIIGGTFFFFPPPGTL~`~LTGGPTGTGGTPGGLLGGGPPPGGGIIGLL~```~LLFFFFFFTTGGGGGGGGGGL~````~LGFFFGGGGTGTGTGTGGGGGB~`
`~BTGTGGGIIGGGLLLLGFGGFFL~LLILLLLLFFFPPPGTL~`~LGGGGGGGTGTPPGGGPGTGGGGTGIIIGGL~`~LLGGFFFFFGGGGGGGGGGGGLL~~~~LLGFFGFTGGGFFGGGGGTGGB~``
`~BGGGGGGIIGIGL~~LLGTTGFL~~LIL~~~LGTFPPPTGL~~LLLLLLGTGGGGPPPPPPPPGGGGGGIIGGTL~~LLGTFFFFFFGTTGTTGGGGGGTTLLLLGGGFGGGGTGTGFFGGGGTGGB~``
`~BGGGGTGIIIIL~``~LGTGGGL~LLIGL~LLGGGPPPFGGLLGGL~~~LLLTGGGPPPPPPPGGGTGIIIIIL~``~LGFFFFFFFFGGTGGGGGGGGGGGGGGGGTGTGTGGTTGTTTTGTGGGGB~`
`~BGTTGTGLLLLL~~~LLGGTTTGLLGIGLLGGGGGPPPFFFGGGL~```~~LGGGGGPGPPPPGGGTGIIIGIL~```~LFFFFFFFFTGTGGGGGTGGGGGTGGGGFFGGGTGTGGGGGGGGGGTGB~`
`~BGGTGTGL~~LGLLLFGGGTGTGIIIIIIGTGGGGPPPFFFFGGL~`````~LGLLLTGGPPPPPPGGIGGGL~````~LFFFFFFFFFGGGTGGTGGTGGTGTGTGGFGTTGGGGGGGTTFGGGGGB~`
`~BGTGTGTGLLGGGFFFGGGTGGGIIIIIIGGGTGGPPPFFFFGTL~`````~LL~~LLGGPPPPPPGGGGGGL~````~LFFFFFFFFGGGGGTGTTTGTGGGGGGGFFFGGGGTGGGFGFFFFGGGB~`
`~BGTGGGGGTGTGFFFFFFGGGGTIIIIIGGTGGTGGPPFFFFPGL~````~LGL~`~LTPPPPPPPGGGGGGGL~~~~LLFGFFFFFGGGGGGGGGGGGGTGGGGGGTFGTTGFFFFFFFFFFFGGGB~`
`~BGTGGTTGGGGGTFFFFFGGGTGIIIIIGTTGLLLGGPFFFFPGGL~~~~LLTL~``~LTPTGPPPPGGGGGGLLLGLGGGGFFFFFGGGTGGGGGTGGTTGGTGGTGFGGTGFGFFFFFFFFFGGTB~`
`~BGGGGGGGGGGGGFFFFGGTGGGGGIIGGGFL~~~LGPFFFFPGGLLLLLGGGL~``~LGPTGPPPPPTTFGGGGLLLLGGGFCGGTGGGGTGGGGTGGGFGGGTGGGGGGGGTGGFFFFFFFFTGGB~`
`~BGGGTGGGGTTLTGGGTTGGGGGGGGGGGFFL~`~LTPIIIIPPGTGTGGGGGL~``~LGPGGPPPPPPGFFFGGL~~LLTGCCCTGGGGGGTGGGGGGGFFFGTGGGGGGGGTFFFFFFFFGGTGGB~`
`~BFFFFFGGGGLLLGGGGGGTGGGGGGGTFFFGL~LLPPIIIIPPPGGTTGGGGL~``~LTPGGGPPPPPGFTFGL~``~LGCCCCGGGTTGGTGGGGGTGFGTGTGGGGTGTGGFFFFFFFGTTGGGB~`
`~BFFFFFFGGGL~LTGGGGGGGGGGFGGGFFFGLLGGGPIIIGPPPGGGGGGGGGL~~LLGPTGGGPPPPGGGFGL~~~LLFGCCCTGGLLLLGGGGGGGGGGGGLLLLGGGGGGGFFFFTGGGGTGGB~`
`~BFFFFFGGGL~`~LTGGGGGTGFFFFGGGFFGTGGGPPIIIGPPPGGTGGGTGGLLLGGGPGTGFGPPPTTGGGGLLLTGGGGCGGGLL~~LLGGTGGIIGLLL~~~LTGGGGGGFFGFGGGTGGGGB~`
`~BFFFFFFGGL~`~LGGGGTTGGFFFFFFGPPPPGTPPPIIGGPPPGTGGGGTGGGTGGGPGGGGGGGGGGGGGGGGGGGGGTTTTGGL~``~LITGGGIIIL~~```~LGGGGTGGFGGGGTGGGGTB~`
`~BFFFFFFFTGL~LLGTGGGGGGTFFFGGPPPPPPPPPPIIGGPPPGGTGGTGTGGGTTPPGGGGGGGGGGGGGGGGGTTTGGTTGTL~````~LGTTGGIL~`````~LGGGGTGGGTGGTFGGTGGB~`
`~BFFFFFFGGGLLTGGGGGGGTTGGPPPPPPPPPPPPPPIIGTPPPTGTGFGGGGFFGGPPGGGGGGGGGGGGGGGGTGGTGGGGGGL~````~LGGGGGGL~````~LLGGGTGTTGTTGGFGTGTGB~`
`~BFFFFFFGGGGGGTGGGGGGTGTTPPPPPPPPPPPPPPIGTGPPPGGGTFFGGGGFFGPPGGGGGGGGGGGGGGGGGGGGGGGGGGGL~``~LLGGGGGGGL~~~~LLTGTGGGGTGFGGGFFGGTGB~`
`~BFGFFFFGGGGGFFFGLLLLGGGGPPGGGGGGGGGGGGGGGGPPPGPPPPPPPPPPPPPPGGGGGGGGGGGGGGGTGFFFFGTGGGGLL~~LLGTGGFGGGLLLLLTGGTGGGGGGFFFGGFFFGGGB~`
`~BGFFFGFGFGGGFFFFL~~LTGGGPPGGGGGGGGGGGGGGGGPPPPPDPPPPPPPPPPPPGGGGGGGGGGGGGGGFGFFFFFGGGGLLGLLIIGGGFFFGGGGGGGGTGGGFFGFGFFFGFFFFGGGB~`
`~BGFFFFGFFFGGFFFFGLLGGGGGPPGGGGGGGGGGGGGGGGPPPPPPPPPPPPPPPPPPGGGGGGGGGGGGGGGFFFFFFGLLLL~~LGGIIIIFFFFFGGGGGGGTFFFFFFFFFTGGGFFFGTGB~`
`~BFFFFFFFFFGFFFFFFGGGGTTGPPGGGGGGGGGGGGGGGGPPPPPFFFFFFFFPPPPPGGGGGGGSGGGGGGGFFFFFFFL~~~`~LLGIIIIFFFFFGGGTTGGGGFFFFFFFGGGGGGFFFGTB~`
`~BFFFFFGGFTGFFFFFFGGGGGGGPPGGGGGGGGGGGGGGGGGPPPPFFFFFFFFPPPPPGGGGGGGGGGGGGGGFFFFFFL~`````~LFFFFFFFFFGGGLLLLLLGFFFFFFFGGGGGGGFFFFB~`
`~BFFFFTGGGGGFFFFGGGGGGTGGPPGGGGGGGGGGGGGGGGGPPPPFFFFFFFFPPPPPGGGGGGGGGGGGGGGFFFFFFL~````~LFFFFFFFFGIIGLL~~~~LFFFFFGGGGGGGGGGGGGGB~`
`~BFFFFGGGGGTFFFGGGGGGGTGGPPGGGGGGGGGGGGGGGGGGPPPFGFGFFFFPPPPPGGGGGGGGGGGGGGGFFFFFFL~````~LGGFFFFFTGIIGL~````~LFFFGGGGGGGGGGGGGGGB~`
`~BFFFFFTGGTGGFFGGGGGGTTGGPPGGGGGGGSGGGGGGGGGGPPPPPPPPPFFPPPPPGGGGGGGGGGGGGGGFFGFFFGL~~~~LLTGGFGGGGIIGGGL~```~LFFGGGGGGGGGGGGGGGGB~`
`~BGFFFFGTGGGGTTGGGGGGGGGGPPGGGGGGGGGGGGGGGGGGPPPPPPPPPGFPPPPPGGGGGGGGGGGGGGGGGTGFFGLLLLLGGGGGGGGGGGGGFGLL~~~LLGGTGGGGGGGGGGGGGGGB~`
`~BFFFFFGGGGGTGGGGTGGGGTGGPPGGGGGGGGGGGGGGGGGGPPPPPPPPPGGPPPPPGGGGGGGGGGGGGGGGGTGGFTGGGGTGTTTGGLGGGGGFFGGFLLLGGGTGGGGGGGGGGGGGGGGB~`
`~BFFFFFGGGGTTTGTGTGGGTGGGPPGGGGGGGGGGGGGGGGGTGGGGGGGGGGGGGGGPGGGGGGGGGGGGGGGGGGGGGTGGTGGGGGTGGLGIITIFFFFFFFGGTGGGGGGGGGGGGGGGGGGB~`
`~BFFFFGGGGGGGGGGTGGGGGGGGPPGGGGGGGGGGGGGGGTGGGGGGGGGGGGGGGGGPPPPPPPPPPPFFFGGGGGGGGTGGGTGGPPPGL~LIITIFFFFFFFFGGGGGGGGGGGGGGGGGGGGB~`
`~BFFFCTGTGGGGGGGGGGGGGGGTPPGGGGGGGGGGGGGGGGGGGGGGGGGGGGGGGGGPPPPPPPPPPPPFGGGGTGGTGGGTTGGGPDPGL~LIIIIIFFFFFFGGTGGGTGGGGGGGSGGGGGGB~`
`~BFFCCCGGGGTGTGGGGGGGGTGGPPGGGGGGGGGGGGGGGGGGGGGGGGGGGGGGGGGPPPPPPPPPPPPPPGGGGGGGGGGGTGGGPPPGGLLIIIIFFFFFGGTGGGGTGGGGGGGGGGGGGGGB~`
`~BGFFCCCGGFFGGGGGGGGGGIGGPPGGGGGGGGGGGGGGGGGGGGGGGGGGGGGGGGGPPPPPPPPPPPPPPTGTGGGGGGGGTGGGMPPTGTGGPPPPPPPPPPPPPPGTGGGGGGGGGGGGGGGB~`
`~BGGIICGFFFFGGGGGTGGIIIIIPPPPPPPPPPPGFFFFGTGGGGGGGGGGGGGGGGGPPPPPPPPPPPPPPFTGGGGTGGGGGGFFFPPPPPPPPPPPPPPPPPPPPPPGGGGGGGGGGGGGGGGB~`
`~BGGGIFFFFFFGGGGGGGGIIIIIPPPPPPPPPPPFFGGGGGGGGGGGGGGGGGGGGGGPPGGGGGFFFFPPPFFGTGGGGGGGGFFFFPPPPPPPPPPPPPPPPPPPPPPGGGGGGGGGGGGGGGGB~`
`~BGIIIFFFFFFGGGGGTGGIIIIIIIIFFGFPPPPGGGTGGGGGGGGGGGGSGGGGGGGPPGTGGGFFFFPPPFFGGGGGGTTGGGFFFGGGGGGFFFFFFFFFFFFPPPPGGGGGGGGGGGGGGGGB~`
`~BBBIIFFFFGGGGGTGGGGGIIIIIIIFFFFTPPPTFFGGGGGGGGGGGGGGGGGGGGGPPGGGGGTFFFPPPFFTPPPTGTGGGGFFFFFTGTGFFFFFFFFFFFFFPPPTTGGGGGGGGGGGGGGB~`
``~~BBIFGFFGGGGGGTGGTGIIIIIIFFFFFGPPPTGGPPPPPPGGGGGGGGGGGGGGGPPGGGGGLLGFPPPFFGPDPGGGGGGTGFFFGGTGFFFFFFFFFFFFFFPPPPPGGGGGGGGGGGGGGB~`
`~B~~BGGGGGGGGGTTGTGGGIIIIIIIFFFFFPPPTGGPDPPPPGGGGGGGGGGGGGGGPPGGGGL~~LFPPPFFGPPPGGGGTGGFFFFGFFGGFFFFFFFFFFFFFPPPPPPPPPPPPPPGGIGGB~`
`~BBBGGGTGGGGTGGGGGGGGIIIIIIIFFFFGPPPTGGPPPPPPGGGGGGGGGGGGGGGPPGGGGL~~LFPPPGGGPPPGGGGGGTGFFFGFFFTTFFFFFFFFFFFFPPPPPPPPPPPPPPGIIGGB~`
`~BTGGTGGGTGGTGGGGTGTGFIIGGGIIFFFFPPPGGGGGGGPPGGGGGGGGGGGGGGGPPGTLL~LLTFPPPGGTPPPGGGGGGGGGGTFFFFGGFFFFFFFFFFFGGGGGGGGGGGGPPPGGGGGB~`
`~BGGGGTGGGGGGGTGGGGGFFTGTGGFFFFFGPPPGTGGGTGPPGGGGGGGGGGGGGGGPPGL~~~LFGGPPPGGTPPPGGGGGGGTGGGTGGGGGGGGGFFFFFFFTTGGGGGTGGGGPPPGGGGGB~`
`~BGGGTGGTGTFFFFGGGGFFFFTGGGGGTFGGPDPGGGGGGGPPGGGGGGGGGGGGGGGPPGL~`~LFFFPPPGTGPPPTGGGGGGGGGGTGGGGGGGGGFFFGFFFGGTGGGGGTGTGPPPGGGGGB~`
`~BGGGGTGGGTFFFFTGGFFFFFFGGGGGGTGHPPPFFGGGGGPPPPPPPPPPPPPPPPPPPGL~`~LFFFPPPPPGPPPGGTGGGTGGGGTGTGTGGGGGTFGGGGGGTGGGGTGGTGGPPPGTGGIB~`
`~BFTGGGGGGGFFFFFTGFFFFFFGGGGGGGGFFFFFFFGGTGPPPPPPPPPPPPPPPPPPPGL~~LLGFFPPPPPPPPPTGGGPPPPPPPPPPPPPPPPGTTGGGFFFTTFFFGGGGGGPPPGGGTIB~`
`~BFFGGGGGGGFFFFFGGFFFFTGGGGGGGGGFFFFFFFFGGGGGGGGGGTFGFFFGGGGGGGGLLFGTFTPPPPPPPPPGGGTPPPPPPPPPPPPPPDPGGGGFFFFFGFFFFTGGGPPPPPGTTGIB~`
`~BFFFGLLLLLLLLLGGGFFFFGGTGGGTGGGFFFFFFFFTGGGTGGGGGFFFFFFFGGGGGGGTGFFFFGGTPPPPPPPGTTGPPPPPPPPPPPPPPPPGGGGFFFFFGGFFFFFFGPPPPPGGGGGB~`
`~BFFFGL~~~~~~~~LGGTFFFGGGGGTGGTGFFFFFFFFFGGGGTGGGGTFGFFFFFGGGGGGGGFFFFFTGGPPPPPPTGGGPPPGGGGGGTGGLGGGTGGTFFGLLLGFFFFFFGPPPPPGTGTTB~`
`~BFFFL~```````~LFGGTFTGGGGGGTGGFFFFFFFFFFFFGGGGGGGFFGFFFFGGGGGGGFFFFFFFGGGGTPPPPGGGGPPPGGGGGGTGLLLGGGGGTGFL~~LGFFFFFFGPPPGGGGGGGB~`
`~BFFFL~`````~~LLFGGGGTGGGTGGGGGFFFFFFFFFFFFGGGGGGGFFFFFFGGGGGGTTGGTFFFFFGGTGGPPPGTGGPPPGGFGGGGLL~LLGTGGGIGL~LLGGFFGFTGPPPTGGGGCFB~`
`~BFFFL~~```~LLFFFGTGGGGGGTGTTGGFFFFFFFGFFFFFGGGGGGGFGFFFFGGFTTGTGFFFFFFFGGGTGPPPPPPPPPPGFFFFTGL~`~LGGGGGIIGLLGGGGGGGGGPPPTGGTCCFB~`
`~BTFFGLL~~~LLFFGFFTGGGGGTGGGTGGGGTFFFFFFFFFFFTGGGGGGGFGGGTFFFTGGGFFFFFFFGGFFGPGTGGPGPPGFFFFFFFGL~LLGTTTTIIIIIIIIIGGGGTPPPGGGCCCFB~`
`~BFFFGTGLLLGGFGGFTTGGGGGGGTGTGGGTGGFFFTFFFFFFFGGGGGTGGGTGGFFFFGTGGBBBGGGGFFGGBBBBBBGGPPFFFFFFFGLLTGGGGGIIIIIIIIIGGGGGGPPPTGGGCFFB~`
`~BGTFFFFFGTTGFFFGGTGGTGTGGGTTFGGTGGTGIGGGFFFFGGGGGGGGGGCGFFFFFGTGB~~BGGGGFGGBB~~~~BGGPPPFFFFFFFGGGGGGGIIIIIIIIIGTGGGGTPPPTGGGGGGB~`
`~BGGGGGFFFFGGGFFGGGGGGGGGTGGFFFGGGGGIIIGTGGFBBBBGGGGGGCCCGFFFFGGGB~`~BBBGGGGB~````~BGGPPPPPPPPPPPPPPPPPPPPPPPPPPPPPPPPPPPGTGGGGGB~`
`~BGTGGGGFFFFTGFGGGGGGTGGFFFFFFFGGGIIIIIGGGTFB~~BBGGGGGCCCCFFGGGGGB~``~~BTGGB~`````~BTGGPPPPPPPPPPPPPPPPPPPPPPPPPPPPPPPPJPGGTGGTGB~`
`~BGGGGTGFFFFGGGGGTGGGGGGFFFGGTGGGGIIIIIGTGGB~``~BGGGGTTGGTGGGGGFGFB~```~BGGB~````~BGGGGPPPPPPPPPPPPPPPPPPPPPPPPPPPPPPPPPPGGGGTGTB~`
`~BBBBBBBBBBBBBBBBBBBBBBBBBBBBBBBBBBBBBBBBBBB~```~BBBBBBBBBBBBBBBBBBB~``~BBB~````~BBBBBBBBBBBBBBBBBBBBBBBBBBBBBBBBBBBBBBBBBBBBBBBB~`
``~~~~~~~~~~~~~~~~~~~~~~~~~~~~~~~~~~~~~~~~~~~`````~~~~~~~~~~~~~~~~~~~````~~~``````~~~~~~~~~~~~~~~~~~~~~~~~~~~~~~~~~~~~~~~~~~~~~~~~``
````````````````````````````````````````````````````````````````````````````````````````````````````````````````````````````````````
