````````````````````````````````````````````````````````````````````````````````````````````````````````````````````````````````````
``~~~~~~~~~~~~~~~~~~~~~~~~~~~~~~~~~~~~~~~~~~~~~~~~~~~~~````~~~~~~~~~~~~~~~~~~~~~~~~~~~~~~~~~~~~~~~~~~~~~~~~~~~~~~~~~~~~~~~~~~~~~~~``
`~BBBBBBBBBBBBBBBBBBBBBBBBBBBBBBBBBBBBBBBBBBBBBBBBBBBBB~``~BBBBBBBBBBBBBBBBBBBBBBBBBBBBBBBBBBBBBBBBBBBBBBBBBBBBBBBBBBBBBBBBBBBBBBB~`
`~BGGGGGGGGGGGGGGGGGGGGGGGGGGGGLGGGGGGGGGGGGGGGGGGGGGGGB~~BBGGGGGGGGGGGGGGGGGGGGGGGGGGGGGGGGGGGGGGGGGGGGGGGGGGGGGGGGGGGGGGGGGGGGGB~`
`~BGJGGGPPPPPPPPPPGGGPPGGGGGGGLLLGGGPPPGGGPPPPPPPPGGGGGBBBGGGGGGPPPGGLLLLGGGGGGGGGGGGPPGGGPPGGGPGGGPPGGGLLLLGGPPPPPPPPPPPPPPGGGJGB~`
`~BGGGGPPPPPPPPGGGGTGGGGFFFFFGL~LLTGGGGGTGCCCCCGMGPGGGGGGGGGGGGGGGGGGL~~~LGGTGTGFFFFGGGGIGGGGTGGGFGGGGGTL~~LTGGGGGGGGGGGGGGPPPPGGB~`
`~BTGGGGPGHGGPPGTGGGGTTGGIIIFL~`~LGGTGGGGGGCCCGGTGPPPPPPGGGPGGGGFFFTL~``~LTGGGGFFFGGGGIIIGGFGGGGGFTGFGGL~``~LGIIIIGGTFTGGTGGGHCGGB~`
`~BGGGGGGGTGGGPGTGGGTTGGIIIITL~``~LGFFFGTGGGCGGGGGGGGGGGGTGGGTGFFFFTL~``~LTTTGFFFFFGGIIIIFFFFGGGFFFFFFGL~``~LGIIIGFFFFFFTGGGGCCCGB~`
`~BBBBBGGGGGTGPGTGGGGTTGIIIIIL~``~LFFFFGGTGTGGGGGGGGGGTGTGGGGGGFFFFGL~``~LGTFFFFFFFFGIIIIGFFFFFGGGFFFFL~``~LLTIIGGFFFFFGGGGGGTCCGB~`
``~~~~BGGPGTGGPGGGTGGTGIIIIIIL~``~LFFFGTTGTGGGLLLGGGTGGGGGGTGGGGFFGGL~``~LGFFFFFFFFGGIIIITFFFFFGGGFFFFL~`~LGIIIIIGFFFFFTGTGGGGGCGB~`
``````~BGPGGGPPPGTTGTGIIIIIIIGL~~LLFFFGGGGGFGL~~LGGGGGGGGGGTGTGGGGGGL~``~LFFFFFFFFTGGIIIGTTGFFFFFFFFFFL~`~LGIIIIGTGFFFGGGGGTGGGGGB~`
``````~BGPGGGGPPGGGGGGIIIIGGGGLLLGGGGFTGTGGGGL~`~LGGGIGGTTTGGGGTGTGTGL~~LLFFFFFFGGGGGIIIGGGGFGGGGFFFFFL~`~LGGIIIGGGFFGGTGGTGGTGGTB~`
``````~BGPGGFGPPPPGTGGFFFTGGGGGGGGGGGFGGGGGGGL~`~LIIIIGGGGGTGGGGGTGGGLLLGGFFFFFFFGGGGIIIIGGTTGGGTFFGGGGL~LLGIIIIGGGGTGTGGGGGTGTGGB~`
`````~BBGPGGFGGPPPGGGGFFFFGGGGGGGGTGGGGGGLLLLGL~LLIIIIIGGGGTGGGGGTTGGGGGGGTFFFFFFGGGGGIIIIIIIIGIGGGGGTGLLGGGIIIIGGGGGGGGGFFFFGGGGB~`
````~BBGGPGFFFGPPPGGGGFFFGGGTGTGTGTGGGGGTL~~LLGLIIIIILLLGFFGTGTGTGTGGGGTGGGGGFFGGGGGGTIGGIIIIIIIGGGGGGGTGGGGIIGGGGGGTGGGFFFFFTFFGB~`
``~~BBGGGPGGFFGPPPGTGFFFFGGGGGTTGLLLLLLLL~``~LLIIGIIIL~~LFFFGGGFTGGGGGGTGGGGGGGTGGGGGFTTGTIIIIIGGGGGGLLLLLGGGGGGGTGGGTGFFFFFFFFGGB~`
`~BBGGGGPPGGGFGGPPGTGFFFGGGGGGGGL~~~~~~~~````~LTGIIIIGL~LTGFGGFFGGGTGGTTGGGGGGTGGGTGGFFGFFGGGTGGGGGLL~~~~LTGGGGFGGGGGGGFFFFFFFGGGB~`
`~BGGGGPPPGTGFGGGPGGGGGGGGGGGGGGL~````````````~LGGGGTGLLGGTFGFFFFTGGGGGGGGGTGGGGGTGTGGFGFFFFTGTGTGL~~````~LGTGFFFGGGGGGGGFFFFFFGGB~`
`~BGGGGPPPGGGGGTGPPPPGGGGGGGGGTGL~~``````~~~``~LGGGTTGTTTGGGGFFFFFGGGGTGGGTGGGTGGGGGGGGGLLLGGGGTGGL~`````~LGGGGFFFTGGGGGGFFFFFGBBB~`
`~BTGGGGGGGTGGGGGPPPPGGGGGGGTTGGGLL~~~~~~LLL~`~LGGGTGGGGGGGGFFFFFGGGGGGGGGGGGGGGGGGGGGGGL~~LGGTFGGL~``````~LGGTFFFGTGTGTGGFFFFTB~~``
`~BGGGGGGGLLLGGTGGGPPPGGGGTGGGGTGGGLLLLLLGGFL~LLGGGGGGGTGGTGFFFFTGGGTGTGGGTGTTGGGGGGGTLL~`~LGGTGGTGL~~````~LGGGTFFTGGGTGGFFFFTB~````
`~BBBBGGGL~~~LGGGTGPPPGTGGGGGGGGGTGFFFFFFGFFLLFGGGGGGGGGGTGTGFFTGGGGGGGGGGGGGGGGGGGLLL~~``~LGGFGGTGLLL~~~~LLTGGGGGGGGGGGFFFGGGB~````
``~~~~BGGL~`~LGTGGGPPGGGGGTGGGGGGGFFFFFFFFFFFFFGFFGGGGGGTGGGGFGGTTGGGGGGGGGGTGGGGGGL~~````~LTGFFGGGIGGLLLLGGGGGTGLLLLLGGGTFTGGB~````
`````~BGGGL~~LGTGGGPPGGLLLGFFGGGGGGFFFFFFFFFFFFFFFFFGGGTGGGGGGTGGGGGGGGGGGGGGGGGGGL~`~~~``~LFFFFGGIIIGGGGTGGGGGTGL~~~LGGTGGGGTGB~~``
`````~BGGGLL~LGGGGGPPGL~~LLFFFGGGTLLLGGGFFFFFFFFFFFFFFGGGGGTGGGGGGGTGGTGGGGTGGGGGGL~~LLL~~LLGFFGGTGIITIILLLLTGTGGGL~LLGGGGGGTGGBBB~`
`````~BGGGGL~~LGTTGGPGL~`~LFTGTGGL~~~LGTGFFFFFFFFFFFFFGGTGFGGGGFFGTGGGGLLLGGTGTGGGGLLGGGLLGGGFGTGGGIIIIIL~~LGFGFGGLLGGGGTGGTGTGFFB~`
``~~~BBGGGGL~~LGGTGGPGGL~LLGTGGGTL~`~LLTGGFFFFFFFFFFFGGGGGFGGGGFFGGGGGL~~~LGGGGGGGGGGGGGGGGTLLLLGGIIIIIIGLLGFFFFGGGGGGGGGGTGGGGFFB~`
`~BBBGGGGGGL~LLGGGGGGGGLLGGGTGTGL~```~LTGFFFFFFFFFTFGGGTGGGTGGGFFGTGGGL~`~LGGGGGGGGGGGGGGGGLL~~LGIIIIIIIIGGGFFFFFFGGGFGGGGTGTGGGFB~`
`~BGGGGGGGGGLLGGGTGTGGGGGGGGGGGGL~````~LLLLLGFFGGGGGGGGGTGGGGTTGGGGGTGL~~~LGGGGGGGGGGGGGGGGL~``~LIIIIIIIGGGGGFFFGGGGGFFFTGGGGGTGGB~`
`~BGGGGGGGGGGGGGGGLLLLGGPGGGGGGTGL~``~`~~~~LFFGTTGGGGGGGGGGGGGGTGGGGGGGLLLGGGGGGGGGGGGGGGGTGL~`~LIIIGGFFFTFGGFGGGTGGFFFFTTGGFGGGGB~`
`~BGGGGGGGGGGGGGGGL~~LGGPGGGGGGGGLL~~L~````~LFTTGGGGGGTGGGGGGGFGGGGGGGTGTGGGGGGGGGGGGGGGGGGGLL~LLIIIGGFFFFFGTGGGGGGGGFFFTGTFFGGGTB~`
`~BGGGGGGGGGGGGGGL~``~LGPGTGGTTGGGGLLLL~```~LFFFGGTGGTGGGGGTGGFFFGGGGGGGGGGGGGGGGGGGGGGGGGGGGGLLGGGGGFFFFFGGGGGGGGGGGFTFGGFFFFFIIB~`
`~BGGGGGGGGGGGGGGL~``~LGPGGTGGGGGGGGGL~````~LFFFGGTGGGGTGGFGFFFFFFGGTGGTGGGGGGGGGGGGGGGGGGGGGGGGGGGTGTFFFFFFGTGGTGTFFFFFFFFFFFFIIB~`
`~BGGGGGGGGGGGGGGL~``~LGPGGTTGGTTGGGGL~``~~LLFFFFGGGGGTGGGFFFFFFFGGGGGGTGGGGGGGGGSGGGGGGGGGTGGTGGTTGGFFFGGGGGFFGGTFFFFFFFFFFFFFIIB~`
`~BGGGGGGGGGGGGGGGL~`~LGPGGGGGTTGGGGGGL~~LLGGGGGFFFGGGGGTGGIFFFFFFFGTGTGGGGGGGGGGGGGGGGGGGGTTTGGGGGGGGGGGGGGTFFFTTFFFFFFFFFFFFFIIB~`
`~BGGGGGGSGGGGGGGGLL~LLGGGGTTGGGTGGGGGLLLGGGGGGGFFFFGGGTGGIIIFFFFFFGGGTGGGGGGGGGGGGGGGGGGGGGGGGGGGTGGGGTGGGGGFFFFGFFFFFFFFFFFGGIIB~`
`~BGGGGGGGGGGGGGGGGFLLGGGTGGGTGIIIGGTGFFFGGGGTFFFFGTGTGGIIIIIFFFFFTTGGGGTGGGGGGGGGGGGGGGGGGGGGGGGGGTGGGGGGGGGFFFFFGGFFFFFFFFGGGGGB~`
`~BGGGGGGGGGGGGGGFFFGGGGGGGGGTIIIIIGIIIFFGGTGGTFFTTGGGFGIIIIIFFFFFGGGGTGGGGGGGGGGGGGGGGGGTGGGGGGGGGTGGFTGGGGFFFFFFGGFFGFTFFFTGGGGB~`
`~BGGGGGGGGGGGGGGFFFFFGPPGGTGIIIIIIIIIIIFFFGGTFFFGGGFFFGIIIIIGFFTIIGGGGGGGGGGGGGGGGGGGGGGGTGGTGGGTGGGFFTGGGGTGFGFTTGGGGGGFFGTGGGGB~`
`~BGGGGGGGGGGGGGGFFFFFGPPGGGGIIIIIIIIIIIIGGTGGFFFFGGGFGGGIIGGGGGIIIITGGGGGGGGGGGGGGGGGGGGGGGGGGGTTTGFFFFFTGGGGGGGGTGTGTGGGFGGGGTGB~`
`~BGGGGGGGGGGGGGGFFFFFGPPGTGTGGIIIIIIIIIIIFGLLLLLLGTGGGGGIIIGGGGIIIIGGTGGGGGGGGGGGGGLLLLLGGGGGGTGGGFFFFFGGGGGTGGGGGGGGGTGIIIIIIGGB~`
`~BGGGGGGGGGGGGGGFFFFFGPPGGGGGTGGIIIIGFFFFFL~~~~~LGGGFGTGGIFFGTGIIIIGFFGGGTGGGPPPPGGL~~~LGGTGTTGGGGGGFFGGGGTGGGGGGTTGGGGGIIIIIIGGB~`
`~BGGGGGGGGGGGGGGFFFFFGGGGGGGTTTGTIITGGFFFFL~````~LGFFFTGGFFFFFGIIIITFGGGGGGGGPPPPGL~```~LGGGGGGGGGGGFGGTGGTGGGGGTGGGGGGGIIIIIIGGB~`
`~BGGTTGGGGTTGGGFFGGLLLLGGGGGGGGGGGGGGGGGGGGL~```~LTFFFFGGGGFTGGGGIGGGGGGPPPPPPPPPGL~```~LGGGGGGGGGGGGGGGGGGGGGGGFGGGGTGTIIIIIITFB~`
`~BGGGGGGGTGGGGGTFGGL~~LLGGGPGGGGGGGGGGGGGGGL~```~LGFFFFGGGGGGTGGGGGGGGLGGGPPPPPPGGL~``~LGGGGGGGGGGGGGGGGGGGTGFFFFFGGGGTGGTIIITFFB~`
`~BGLLLGGTTGGGGGGFGL~``~LLGGPGGGGGGGGGGGGGGGGL~~~LLGGFFGGGGGTGGGGTTGGGLLLGGPGGGGGGTL~``~LGGGGGGGGGGGGGGGGGGGFFFFFFFGTTGGGGTGGIGGFB~`
`~BL~~LFGGGGTGGGTFGL~```~LLGPGGGGGGGGGGGGGGGGLLLLGGGGFFTGGGGGGGGGTTGGLL~LLGGGFFFTGGGL~~LLGGTGGGGGGGGGGGGGGGGGFFFFFFFGGGGGGGGFGGGGB~`
`~BG~LLFFGFGGGGGGGL~`````~LGPGGGGGGGGGGGGGGGGGGGTGGGLLLGGGGTGTGGGGGGGL~`~LGGTGGGGTTGLLLGGGTGGGGGGGGGGGGGGGGGFFFFFGGTGGGGGGGGFGGGGB~`
`~BGLLGFFFFFTGGGGGL~``~~~LLGPGGGGGGGGGGGGGGGGGGTGGGLL~~LGGTGGGGGGPPPGGL~LLTGGTGGGGGGGGGGGGGGGGGGGGGGGGGGGGGFFFFFFGGTGGGGGGGFFGGGGB~`
`~BGGGFFFFFFGGGGTGL~~~LLLGGGPPGGGGGGGGGGGGGGGGGTGGGL~`~LTGGGGGGPPPPPGGLLGGGGGGGPPPPPPPPPPPPPGGGGGGGGGGGGGGGFTGFFFFGTGGGGGGGGGGGGGB~`
`~BGGGFFFFFGGGGGGGGLLLGGGGGGPPGGGGGGGSGGGGGGGGTTGGGGL~LLGGGPPPPPPPPPGGGGGGGPPPPPPPPPPPPPPPPPGGGGGGGSGGGGGGGFFFFFGGGGGGTTTGGGTGGGGB~`
`~BGFFFFTFGGGTGTGTTGTGGGGGPPPPGGGGGGGGGGGGGGGGFFFFFGLLGGGPPPPPPPPGGGGGGGGPGGGGGGGGGGGGGGGPPPGGGGGGGGGGGGGGGFFFFGGGGGGTGGGGTGGGGGGB~`
`~BGGGFFGGGGGGGTGGGGGGGGGGGGPPGGGGGGGGGGGGGGGFFFFFFGGGGGGPPPPPGGGGIIIIIIGGGFFFFFFFFFFFFFCCCMGGGGGGGGGGGGGGGFFFGGGGGGGGGGTGGTGGGGGB~`
`~BGGGFGTGGTGGGGGGGGGGGGGGGGPPGGGGGGGGGGGGGGGFFFFGGGPPPPPGGGGGGTTGTGFIIGGGTGFFFFFFFFFFFCCCCCGGGGGGGGGGGGGGGFFFGTGGTGGGGGTGGGGTGGTB~`
`~BGGTGGTTFGGLLLLGGGGGGGTGGGPPGGGGGGGGGGGGGGGFFFGGGPPGGGGGFFFTGGLLLGFFFFGGGGGFFFFTGFFGTGCCCTGGGGGGGGGGGGGGGFFFFFFGGGGGGGTTTTGGGGGB~`
`~BGGGTGGFFFGL~~LLGLLLLGGGGGPPGGGGGGGGGGGGGGGFFFFGGGPGFFFLFFFGGL~~LLFFFFGGTTGGFFFFGGFIIILGGGGGGGGGGGGGGGGGGFFFFFFTGGGTGGTGGGGGGFFB~`
`~BGGGGGGTFGL~``~LLL~~LGGGTGPPGGGGGGGGGGGGGGGFFFFTTGPGGGLLGGGGGL~`~LFFFFTGGGLLLLGGGTGGILLLGGGGGGGGGGGGGGGGGFFFFGLLLLGGGTTTGGGGGGGB~`
`~BGGGGGGTGGL~```~L~``~LGGGGGPGGGGGGGGGGGGGGGGFGFGGGPGGLL~LGGGGL~~LLFFFFGGGGL~~LGGGIGILL~LTGGGGGLLLLLLGGLLLGFFGGL~~LGGGTGGGGGGTTGB~`
`~BTTGGGGGGGL~````~```~LTGGTGPPPPPPPPPPPPPPPPGGGGTGPPGGL~~LGGGGGLLGGFFTGGGGL~``~LTIIILL~`~LGGGGTL~~~~~LL~~LGFFFL~``~LGGGTGGGGGTGGB~`
`~BGGGGGGGGGL~``~~~~``~LGFGGGPPPPGGGPPGGGGGGGGGPGGGPPGL~`~LGGPGGGTGGGFGGGGGL~``~LTIIIL~``~LLLLLL~`````~~``~LGGFL~``~LGGGTGTGGGGGGB~`
`~BGGGGGLLLL~``~LLLL~~LLGTGGGGGGGGTGGGGGLLLLLGGPPGGPPGL~`~LGGGDPGGGPGGLLLLGL~``~LGIIL~````~~~~~~``````~~~`~LGFFFL~~LLGGGTGGGGGTGGB~`
`~BGTTGLL~~~``~LGFGFLLGGGGGTGTGTGTGGTGGGL~~~LGGPPPGPPGL~~LGTTGGGGGPPGGL~~LTGL~~LLIIIL~````````````~~~~LLL~LLGTGGLLLGGGGTGGGGGGBBBB~`
`~BGGTGL~`````~LFFGFFFGGGGGFFTGGGTGGGGGL~```~LGPPPPPPGL~~LGGGGGTTGPPGL~``~LTLLLGGIIIGL~``````````~LLLLGGGLLGGGGGTGFFFFTGGTTGGBB~~B~`
`~BGGGL~``````~LFFFFFFFGGGFFFGTGGGGGGGGL~```~LGPPPPPPGGLLGGGGGGGTGPGGL~``~LIIIIIIIIIGLL~````````~LLGGFGGGGLLLLGGTFFFFGGGGGTGGB~`~~``
`~BGTTL~`````~LLGFCCFFGGGFFFFGGGGGGGGGGL~`~~LLGPPPPPPGGGGTGGPPPGGGPGTL~``~LIIIIIIIIIGGGL~~~~~~~~LLGTGFFGGL~~~LTGGFFFFFFTGGGTGGB~BB~`
`~BGGGGL~~~~~LLGFFCCCTTGGGFFFFGGTGGTGGGGL~LLGGGPPPPPPPPPGGGGGGGGPPPGGGL~~LLGGLLLGIGGGGTLLLLLLLLLGGGGFFGGL~```~LGGGFFFFFGGGGGGGBBGB~`
`~BFGGGLLLLLLFGGGCCCGGGGFGGFFGGGGGGTTGGGLLGGGGGPPPPPJPPPPPGGTLTGGPPPGGLLLGGGLL~~LLLGGGGGTGGGFFFFFGFGFGTGL~```~LGGFFFTGTGGTGGGGGGGB~`
`~BFGGGGGGGGFFFGGGCGGGGGFTGTGGGGTGTGTGTGGGGGGGGPPPPPPPPPPPGGLLLGGPPPGFFFGGTLL~``~~~LGGGGTGGGFFFFFFFGGGGLL~``~LLFFFFGGGTFGTGGGGGGGB~`
`~BFFGGTTGGGGFTFGGTGTGGFFFFGGGGTGTTGGTGGPPPGGGGGGPPPPPPPPPGGL~LTGPPPGGFFGGLL~`````~LGGGGGGGGFFFFFFGGGGLL~``~LGFFFFFGGGFFFGGGGGTGGB~`
`~BFFGGGGTGGFFFFFFFGIIIGGFGTGGIIGGTGGGGPPGGGLGGTGPGGGGGGGGGL~`~LGPPPGGGGGLL~``````~LGGGGGGGTFFFFFFFGGLL~```~LGGGFFFTGGTFGGGGGGGGGB~`
`~BGFTGGGGGGFFFFFFTGIIIIGGTGTGGGGGGGTGPPPGGLLLGTGPGTGIIIIGGL~`~LGPPPGGGGTL~``````~LGGTGGGGTGFGFFFFFFLL~````~LGGTTFGGGGFFTGGTGGGGGB~`
`~BGGGTGGGTFFFFFFFFGIIIIILGGGGGGGGGTGGPPPGGL~LTGGGGIIIIIIGGGL~LLGPDPGGGGGGL~`````~LGGGGFFFFFFTFFFFFFL~`````~LGGTGGGGGGFFFGGGGGGGGB~`
`~BGTGGGGGGFFFFFFFFFGIIIGLLGGTGTGTGGGPPPGGL~`~LGGGGIIIIIIGGGLLGGGGGGGGGGGGLL~```~LLGFFTGFFFFFFFFFGGGGL~````~LGGTTGTGTFFFFFFGGGGGGB~`
`~BGGGTTGGGGGFLLLLGFIIIIL~LLGLLLLLGGGPPPGGL~`~LGGGGGGGIFFGGGGGGGGFFGGGGGGTGGL~`~LLGGFFFGFFFFFFFFGGTGGLL~~~~LLTTGTGGGGFFFFFGTGGGGB~``
`~BGTGGGGTGGGGL~~LLGIIIIL~~LIL~~~LGGGPPPGGL~~LLLLLLGTGGFFGPPPPPPGFFFGTFFFGGGL~~LLGFFFFFFFFFFFFFGGGGGGTTLLLLGGGGGGGTGGGFGFGGGGGGTB~``
`~BGGTGGGTGGGL~``~LIIIIIL~LLIGL~LLGTGPPGGTGLLGGL~~~LLLGGGGPPPPPPGFFFGFFFFFFL~``~LGIIFFFTFFFFFFFFGGTGGTTGTFFGTGGGGTGGGFFFFFGGGGTGGB~`
`~BGGTGGGLLLLL~~~LLIIIIIGLLGIGLLGGGGGGPGTGGGGGL~```~~LGGGGGGGGPPGFFFFGFFFFFL~```~LIIFFGGFFFFFFFGGGGGGGGGFFGTGGGTGGGGGFFFFFGGTTGGGB~`
`~BGFFFGTL~~LGLLLGGGGIIIIIIIIIIFFFGGTGPGGGGGGGL~`````~LGLLLGGGPPGGGGFTGFFFL~````~LGTGGGGTGGGFFFGGGTGGGFFFFGGGTFGFGGGGFFFFFFGGGFFFB~`
`~BFFFTFFGLLGGGGGGGGGGGIIIIIIIIFFFFFGGPGFGGGGGL~`````~LL~~LLGGPPPPPGGTGGTFL~````~LGGGGGTGGGGGFTGFFTGGGFFGTGGTFFFFFGGTTFFFFFGGFFFGB~`
`~BGGGGFFFFFFGGTGGGGGTGIIIIIIIFFFFGGGGGGFTGGPGL~````~LGL~`~LGGGGGPPPGGGTGGGL~~~~LLGGGTGGGGGGGGGTFFFGTFFGTGGGFFFFFFGGGGFFFFFTFGFFGB~`
`~BFGGGGFFFFGGGGFFGGGGIIIIIIIIFFFGLLLGGGFFGGPGGL~~~~LLGL~``~LGGTGPPPGTTGGTGLLLGLGGGGGFFGGTGGGGGGGFGGFFFFFGGFFFFFFGTGGGGFFFFFFFFFFB~`
`~BFGGTTFFFFTTGFFTTGGTGGGTIIIFFFFL~~~LGGFFGGPGGLLLLLTGGL~``~LGGGGPPPGGGGGGGGGLLLLGGGFFFFGGGGGGGTGGGTFFFFGGTGFGGFFFGGGGGGGTFFFFFFFB~`
`~BFGGGGFFFFFLTFFFGGGGTGGGGGTFFFFL~`~LGGFFFGGGGFFGGGGGGL~``~LGGGGGGPPPGTGGGGGL~~LLGTGTFGGGGTGGGGGGGGGFFFGGTGGGFFFFTGGGFTGTFFFFFFFB~`
`~BFGGGGFFFGLLLGFGGGGGGGGGGGTFFFFGL~LLGGFGGTGPGGFGGGGTGL~``~LGGFFFGGPPGTTGGGL~``~LTGGGTGGGGGGGFTTGGTGTGFGGGTGGFFFFGGGFFGGTTFFFFGGB~`
`~BFGGGGGFFTL~LGGTGTTGGGTGGGGGGGGGLLGGGGTGGTGPPGGTGGGGTGL~~LLGGFFFFGPPGGGGGGL~~~LLGTGGGGGGLLLLFGTGGGTGGGGGLLLLGFFFGFTFFGGGGFFFFFFB~`
`~BFFFGTGGFL~`~LGTGGGGGGTGGGGGGTGGGGGGGGFFFTGPPGGGFFTGGGLLLGGGGFFFFGPPPGGGGGGLLLTGTGGGTGGLL~~LLGGGGGGGGLLL~~~LFFFFFFFFFFGGTFFFGFFB~`
`~BFFGGGGGGL~`~LGGTGGGTGGGTTGTGGGPPGTGPGFFFFGPPGGGFFFTGGFGTGGGGGGGGGGGGGGGGGGGGTGGGGTGGGGL~``~LIGGGGGGGL~~```~LFFFFGFFFGGTGGGFGFGB~`
`~BFFTGGGGGGL~LLGGGGTGGGGGGGGGGPPPPGGGPGFFFFGPPGFFFFFFGFFFTGPPGGGGGGGGGGGGGGGGGGGGGGGGGGL~````~LGTGGGGL~`````~LFFFGGGFTGGGTGGGTTGB~`
`~BFFGGTGGGGLLGGTGGGGGGTFFGPPPPPPPPPPPPGFFFGGPPGTFFFFGFFFGTGPPGGGGGGGGGGGGGGGGTGTGGTGTGTL~````~LGGGGGGL~````~LLFFFFFGFFFGGTGGGGGTB~`
`~BTGTGTGGGGGGGTTGGGGGGGFFGPPPPPPPPPPPPGFGGTGPPGGFFFFGGGFGTGPPGGGGGGGGGGGGGGGGTGGGGGTGGGGL~``~LLTGGGGGGL~~~~LLFFFFFGGGFGGGTGGGGGGB~`
`~BGTGGGTGTGGGGGTTLLLLGGFFGPGGGGGGGGGGGGGGGTGPPGGGGGGGPGGGGGPPGGGGGGGGGGGGGGGTGGGTGTGGGGGLL~~LLGGGGGTGGLLLLLFGGFFGGGTTGGGGGGGGTTGB~`
`~BGGGGGGTGGTGGGGGL~~LGGFFGPGGGGGGGGGGGGGGGGGPPPPDPPPPPPPPPPPPGGGGGGGGGGGGGGGGGGGGGGGGGGLLGLLGGGTGTGTTGTFFFFFFFFGGGGGGTTGGGGGGGGGB~`
`~BFFFGGGTGTTGTGTGGLLGGGFFGPGGGGGGGGGGGGGGGGPPPPPGGGGGGGGGPPPPGGGGGGGGGGGGGGGFFGGGGGLLLL~~LGGTFFFTGTTGGGTTGFFFFFGGGGGGTGTTGGGTGTGB~`
`~BFFFFGGGTGTTGTGGGGGGGGFFGPGGGGGGGGGGGGGGGGPPPPPGIIIIIIIGPPPPGGGGGGGSGGGGGGGFFFGGTGL~~~`~LLGFFFFTGGGGTTTGGGGGTGGTTGGGGGGGGGTGGGTB~`
`~BFFFFTGGGGTGGGGGGGGGGGFFGPGGGGGGGGGGGGGGGGGGPPPGGGIIIIIGPPPPGGGGGGGGGGGGGGGFFTGGTL~`````~LFFFFFGGGGGGGLLLLLLGTTGTGGTGGTGGGTTGGGB~`
`~BFFFFGGGFTGGFFGTTGGGGGTGGPGGGGGGGGGGGGGGGGTGPPPGGGIIIIIGPPPPGGGGGGGGGGGGGGGTGGGTGL~````~LGGFFFFGGGGFFLL~~~~LTGGGGGGGGGGGGGGGGGGB~`
`~BFFFGGTTFTGFFFFGGGGGTGGGGPGGGGGGGGGGGGGGGGGGPPPGGTGIIIIGPPPPGGGGGGGGGGGGGGGGGGGGGL~````~LGFFFFTGGGGFFL~````~LFGGGGGGGGGGGGGGGGGB~`
`~BFFFGGFFFFFFFFFFGGGTGTGTGPGGGGGGGSGGGGGGGGGGPPPPGGGGGIIGPPPPGGGGGGGGGGGGGGGGGTGGGGL~~~~LLGGGFFIIIIIFFGL~```~LFFFGGGGGGGGGGGGGGGB~`
`~BFFGGFFFFFFFFFFFGTGGGGGGGPGGGGGGGGGGGGGGGGFGPPPPPPPPGIIGPPPPGGGGGGGGGGGGGGGGGGGGFGLLLLLGGGGFFFIIIIIFFFLL~~~LLFFFFGGGGGGGGGGGGGGB~`
`~BGGGGGFFFFFFFFFFGGGGGTGGGPGGGGGGGGGGGGGGGGGGGPPPPPPPGIIGPPPPGGGGGGGGGGGGGGGGGGGFFTGGGGGTGGGGFLIIIIIFFGGGLLLGGFFFTGGGGGGGGGGGGGGB~`
`~BGTGGGGGGGGGGFFGFFGTGGGTGPGGGGGGGGGGGGGGGGGTGGGGGGGGGGGGGGGPGGGGGGGGGGGGGGGGGGGFFFGGGTGTGGTGGLGIIIIIIIGGGGGGFFFFGGGGGGGGGGGGGGGB~`
`~BTTGTTTGGGTGTTGTFFFGGGFGGPGGGGGGGGGGGGGGGGTGGGGGGGGGGGGGGGGPPPPPPPPPPPGGTGGTGTGGFFGGGGGGGGGTL~LIIIIIGGGGGGGTGFFGGGGGGGGGGGGGGGGB~`
`~BTGTGGGGTTGTGTGGFFFFTFFFGPGGGGGGGGGGGGGGGGTGGGGGGGGGGGGGGGGPPPPPPPPPPPPGTTGGTTGGGGGGGGTGGDGGL~LTTIIIGGGGGGGGGGFGTGGGGGGGSGGGGGGB~`
`~BGGGGTGGTFFGTGGGGFFFFFFMGPGGGGGGGGGGGGGGGGGGGGGGGGGGGGGGGGGPPPPPPPPPPPPGGGTTGGGGGGTGGTGTGPPGGLLGGGGGGGGGGGGTTGGGGGGGGGGGGGGGGGGB~`
`~BGGGGGGGGFGTGGGGGFFFFFFFGPGGGGGGGGGGGGGGGTGTGGGGGGGGGGGGGGGPPPPPPPPPPPPPPGGGGGTGTGGGGGGGGPPGGGGGPPPPPPPPPPGGGGGGTGGGGGGGGGGGGGGB~`
`~BGGTIIGTGFFGTGGGGTTGFGFFGPPPPPPPPPPGGGGGGGGGGGGGGGGGGGGGGGGPPPPGGGGGGPPPPGGTGGGGGGGGGGGGGPPPPPPPPPPPPPPPPPPPPPPGGGGGGGGGGGGGGGGB~`
`~BGIGIITGFFFGTGGGGGGGTGFFGGGPPPPPPPPGGTGGGTGGGGGGGGGGGGGGGGGPPGGGTTGTGGPPPGGGTGGGGGGGGTTGGGPPPPPPPPPPGGGGGGPPPPGGFGGGGGGGGGGGGGGB~`
`~BIIIIIGFFFGGGGGTGGGGGGTFGTGGGGGPPPGGGGGGGGGGGGGGGGGSGGGGGGGPPGGGGGGGTGPPPGTTGGGTGTGGGFGGTGGGGGGGGGGGGTGGTGGGGPGFFGGGGGGGGGGGGGGB~`
`~BBBIIGGGFFGGGGGGGGGGGIIGGTGGGGGGPPGTGGGGGGGGGGGGGGGGGGGGGGGPPGGGGTGTGGPPPGGGGPGGTTGFGFGGGTGTFFFFFGGGGGGTGGGTGPGFFGGGGGGGGGGGGGGB~`
``~~BBGGGGGGTGGGTGTGTGIIIGGGGTTGGGPPGGTGPPPPPPGGGGGGGGGGGGGGGPPGGGGGLLGGPPPGGGPDGGGGFFFGGGGGGGTFFFFGGTFFFGGGGGGPGGGGGGGGGGGGGGGGGB~`
`~B~~BGGTGGGGFFGGGGGGGGIIIGGTGGGGGPPGTGGPDPPPPGGGGGGGGGGGGGGGPPGGGTL~~LGPPPGGGPPGFFFFFFGTGGGGGTGFFFGGFFFFFFGGGGPPPPPPPPPPPPPGGIIIB~`
`~BBBTGGGGGGTFGGGGTGTTGIIIGTGGGGGGPPGGGGPPPPPPGGGGGGGGGGGGGGGPGGGGGL~~LGPPPGGGPPGFFFFFFFGGTGGGGTFFFGGFFFFFFFGTGGPGGGGGGGGGPGGIIIIB~`
`~BTGTGGGGGGFFTGGGGGGGGIIGGTGGGGGGGPPGGGGGGGGPGGGGGGGGGGGGGGGPGTGLL~LLGGPPPGGGPPGTFFFFTGGTTGGGTGGTGTGFFFFFFGTGTGGGTTFFFFFGPGTIIIIB~`
`~BGTGGGGGGGFFGGGGGFFFFGTGTGTGGTTTGPGGTGGGGTGPGGGGGGGGGGGGGGGPGGL~~~LTGGPPPGGGPPGGFGFTGGTGGGGTGTGGGGGFFFGGFFTGGGGGGGFFFFFGPGTIIIIB~`
`~BGTIIIIGGTFGGGGGTFFFGGGGTGTGGGGGGDGTTGGGTGGPGGGGGGGGGGGGGGGPPGL~`~LGTGPPPGGGGPGTGGGGGGGGGGTTGGGTGGGGFGGFFFFFGTGTGGTFFFFGPGGGIIIB~`
`~BGGIIIIIGGFGGTTGFFFFGGGGGTGGTTGGGGGTGGTGFGPPPPPPPPPPPPPPPPPPPGL~`~LGGGPPPPGTGPGGGGGGGGGGGGGGGGGGGGTGFFFFFTGGGGGGTGGGFFFGPPGGGGGB~`
`~BFGIIIIIGGGGGGGTGTFGTGGGGGGGGGGTTGGTGFFFFGGPPPGGGGGGGGGGGGGGGGL~~LLGTGPPPPGGGPPGTGGPPPPPPPPPPPPPPGGTGGGGFGGTTTGGTGGGGTFGPPGGGTGB~`
`~BFFFIIIIGGGGTGGGGGTGGTGGGGGTTGGGGGFGFFFFFFGGGGGFFFFFFFFFFFFFGGGLLGGGGGGGGPPPPPPGGGGPPPPPPPPPPPPPPDGTGGGGGGGGGTGGTTFFFGGGPPGGGGGB~`
`~BFFFGLLLLLLLLLGGGGTGTGTGTGGGGGGGGTFFFFFFFFGGGFFFFFFFFFFFFFFFGGTGGGGGTGTTGPPPPPPGGGGPPPPPPPPPPPGGGPGTGTGGGGTGFFGTGGGFFGPPPPGGGGGB~`
`~BFFFGL~~~~~~~~LGGGGTGGGGGTGGGGGGGGTFFFFFFFGGFFFFFFFFFFFFFFFFFGGTTGGGGGGTGGPPPPPGGTGPPPGGGGGGGGGLGGGGGGGGGGLLLGGTTGFFFGPPPPGGGGTB~`
`~BGFFL~```````~LGGGGGFGTGGGGGGGGGTGGFFFFFFGGGGFFFFFFFFFFFFFFGGGTGGGGTGGGGTGGPPPGGGGGPPGGGGGGGGGLLLGGGTGGGGL~~LGGGTTGFFGPPGGGGTGGB~`
`~BTGFL~`````~~LLGGFFFFFFGTTGTGTTTTFTFFFFFGTGGFFFFFFFFFFFFFFFFGTGFGTGTGGGGGGGGGPGTGGGPPGTGGGGGGLL~LLGTGTTGGL~LLIIGGGGFGGPPHTGGGGTB~`
`~BGGGL~~```~LLGGGGTFFFFFGTTTGGGGGFFFFFFFGGGGGGFFFFFFFGGGGGFFFFFGFFGTTFFFGGGGTGPGGGPPPPGTTFGGTFL~`~LGGGTGIIGLLGIIIGGTGGPPPGGGTGTTB~`
`~BGTGGLL~~~LLGGGGFFFFFFFGGTTGGTGFFFFFFFFTGGGGGGFTFGFGGGTGGFFFFFFFFFGGFFFFTGGGGGGGGGGGPGFFFFFFFGL~LLTCGGGIIIIIIIIIGGGGGPPGGFFGGGGB~`
`~BGGTGFFLLLIGGGGGGFFFFFFFTFGGGGGFFFFFFGGTGTTGGGGTFGGGGGGGGGFFFFFFGBBBGGGGGGGGBBBBBBGGPGFFFFFFFGLLGGGCCGIIIIIIIIIIGGTGGPPGTGFFFGGB~`
`~BGGGGIIIIIIIIGGGGFFFFFFFFFFFCFGFFFFFFGGGGGGTGTTGGGGTGFFFFGGGFGFGB~~BGGGGGGGBB~~~~BGGGGGFFFFFFTGGGGGCCCIIIIIIIIIIGGGGGPPGGGFFFGGB~`
`~BGGTIIIIIIGFGGGGTTFFFFGGFFFCCCFTGFGFTTTTGGFBBBBGGGGGGGFFGGGGFGGGB~`~BBBFGFFB~````~BGGGGGGGGGGGGPPPPPPGGGGGGGGGGGGPPPPPPPGTGFGGGB~`
`~BGGGIIIIIIGFFGTGGFGFTGGGGFCCCCCFFGGGGGGGGFFB~~BBGTGGTFFFFFFGGTGGB~``~~BFFFB~`````~BGGGPPPPPPPPPPPPPPPPPPPPPPPPPPPPPPPPJPMGGFGGGB~`
`~BGGGIIIIIIFFFFGFFFGGGGGTGGFFFFFFGTGGGGGTGFB~``~BGGGGTGFFFFFFTGGGGB~```~BFFB~````~BGGGGGGGGGGGGGGGGGGGGGGGGGGGGGGGGGGGGGGGGTGGGTB~`
`~BBBBBBBBBBBBBBBBBBBBBBBBBBBBBBBBBBBBBBBBBBB~```~BBBBBBBBBBBBBBBBBBB~``~BBB~````~BBBBBBBBBBBBBBBBBBBBBBBBBBBBBBBBBBBBBBBBBBBBBBBB~`
``~~~~~~~~~~~~~~~~~~~~~~~~~~~~~~~~~~~~~~~~~~~`````~~~~~~~~~~~~~~~~~~~````~~~``````~~~~~~~~~~~~~~~~~~~~~~~~~~~~~~~~~~~~~~~~~~~~~~~~``
````````````````````````````````````````````````````````````````````````````````````````````````````````````````````````````````````
