CJCGFFFFGGGGGGGGGGGGDPPGGGFFFFGGGGGGFFFFFFGGGGGTG~~GTGGGTTGGGTGGGGGGGFFFF~~~~~GTGTGGGGGGGGGTFGFGGGGGGGGGTTGGGGGGGGFFFFFGTGTGGCCC
CPMTFFFFGGTFFGGGGTGTGGPGGGGFFFFGGGGGGFFFFFFTGGGT~~~~GTGGGGGGGGGGGGGGFFFFGG~~~~GGGGGGGGGGGTGGFFFGTGGGGTGGGGGGGGGTTFFFFFGTGGGGGTCC
CPFFFFFFFGGFFFFGGGGGGGPPGGFFFFFFGTGGFFFFFFGG~~~~~~~~~GGTGGGGGGFFFTGFFFFGGT~~~~GGGGGGGGGGGGGGGFFFGTGGTGGGGGTGTGGFFFFFFFFFGGGTGGGC
HPFFFFGTGGFFFFFGFFGFF~~PGGFFFFFFGGGFFFFFFGGGGG~~~~~~~~GGGGGGGFFFGGGGTFGTGG~GGGGGGGGGGGGGTGGGFFGGGGGTGGGGTGGTGGFFFGFFFFFFGGGTTGGG
FPGGFFGGGGGFFFFFFFG~F~~PGGFFFFFFGGGGGGFFFGGGGGG~~~~~~~~GGGGGFFGGTGGGTGGGTGGGGGGGGGGGGGGGFFGGFFGTGGGGGGGGGGGGGGGFFFFTFFFFTGGGGGGG
FPPGFFGGGGFFFFFFFF~~~G~PGGGFFFFFFGGGGGFFGGGTGGG~~~~~~~~GGGGGGGTTGGGGTGTGGGGGGGGGGGGGGGGGGGGGFTGGGGTGGGTGGGGGGG~FFFFFFFGGGGGGGGGG
FPPPFFGGTGFFFFFFF~~~TG~PGGGFFFFFGGGGGGFFGTTGGGGG~~~~~GFGGGGGGTGGGGGGFGGGGGGGGGGGGGTGGGGGTGGGGGGGTGGGGGGGGGGGG~~~~FFGGGG~GGGTGGGG
FPGPGGGGGGGFFFFFF~~GGGGPGTGGFFFFGG~G~GGFGGGGGTGGGG~~GFFTGGGGGTGGGGGFFFGGGGFFGTGGGTGGGGGGGGTTGG~GGGGGGGTGGGGGGG~~~~FTGG~~~GTGGGTG
FPTPGGGGGGGGFFFGFG~GGGTPGGGGGGGGG~~G~GTGGGGTGGTGGGFFGFFFTGGGGTTGGGFFFFFFFG~FFFFFFGGGGGGTGFGG~~~~~GGGGGGGGGGGGGG~~~~G~~~~~~~GTGGG
FPGPGGGGGGGGFFFFGGGGGGGPTGTGGTGGG~~~~~GGGTGGGT~~FFFFFFFFFFFFFGGGGGFFFFGGG~~~~FFFFFFFGGGFFFFGTG~~GGFGGGGGGGGGGG~~~~~GGG~~~GTG~~TG
FPGPPPPPPPPPPPPPTGGTGGGPTGGGGGGGG~~~~GGGGGGGG~~~~GFFFFFFFFFFFFGGGGFFFFFG~~~~~~GFFFFFFFFFFFFFFFG~GFFFGGGGGGGGTGG~~~~GT~~~~GGG~GGG
FPGGGGGGGGGGGGGPPPPPPPGPGGGGGGTGG~~~GGGGGGGGG~~~GTFFFFFFFFFFGTGGGGTF~~~G~~~~~~FFFF~~~~FFFGFGFGT~TFFFFGGGGGGGGFF~~~GGGG~~GMG~~GGG
FPGGGGGGGGGGGGGTGTGGGPPPPPGGGGFFF~~~GTGGGG~~GGG~~FFFTFFFFFFFGGGGTGGG~~G~~~~~~~FFFF~~FFFFFGGGTGGGFFFFFTGGGGTTGFFF~~GPPPPPPPPGGGGG
FPGGGTTGGGTGGGGGGGGGGGGTGPPPFFFFF~~GGGGGG~~~~G~~~~~GGGFFFFFFFGGGGGGGGGG~~~~~~FFFFF~FFFFFGGTGTGGGGFFFGTGGGTGGFFFFFFPPGGGGGGPGGGGG
FPGTGGGGGGGTGGTGGTGGGFGGGGGPFFFFFFGTGGGG~~~~~~G~GGGGGGFFFF~~GGGGTGGGG~~~~~~~~FFFFFTFFFGGGGGGGGGGGGGGGGGGGGGGFFFFPPPTGGGDPPPTGGTG
FPGGGGGTGGGGGGGGGGTG~FFFFGGPPFFFFGGGGTGGG~~~~~~~GGGTTTTFFFFFFGGGGGTGGGT~~GT~TFFFFFFGFGGT~~GGGGGGGGTGGGGGGFFFTPPPPGGGGGGTGTPGGGGG
GPGGGGFFFGGGGGGTTGT~~~GFFTGGPFFFTGGGGTTGG~~~~FFGGGGGGGGFFFFFGGGTGGTGGGGG~TFFFFFFFFFFGGG~~~GTGGGGGGGGGTGFFFFFPPTFFGFGGGGGGTP~GGGG
GPGGGTFFFFFGGGGGTG~~~GGFFFGFPPFFGGGGGGGGGTGTFFGTGGGGGGGFGFFFGGFGTGGGGGGGGFFFFFFFFFFFGGGG~~~~GTGGTGGGGGFFFFFFPGFFFFFFGGGGGTP~GGGG
GPGGGFFFFFFGGGGGGGGGGGFFFFGFGPTGGGGTTGTGGGGGFGGGGGTGTTGGFF~FGGFGGGGGGGGGGFFFFFFFFFFFFGG~~~~~GGGGGGGGGFGGFFFPPFFFFFFFFFGGGGP~~TGG
GPTGGFFFFFFGGGGTGGGGGFFFFFFFFPPPGGTGGGGGGGGGGGGGGGGGGGGGG~~~GTGGGGGGGGGGFTFFFFFFFFFFFGG~~~~TGGGGGTGGFFTFFFFPFFFFFFFFFTGGGTP~~GGG
GPTGFFFFFFFFGFFGGGGGGGGFFTFGGGGPPPPPPPPPPPPPPPPPPPPPPPPPPP~~~~GGGGGGGGTGFFFFFFFTFFFFFGT~~GGGGGGGGGGGFGGFFFFPFFFFFFF~GTTTGGPG~GGT
GPGTTFFFGGFGFFFGGGGGGGGGTTFFGGGGGGGGGGGGGTGGGT~~~~~~~~GGGPPGTGTTGGGTGGTGTGFFFFGGGGFFFGGG~GGGGGGGGGGGGGFFFFGPFFFF~~~~GGGGGTPTGGTT
GPGGGGGFGGGGFFFGGGGGGGGGGG~~~GGGGGGGGGTGTGTGGGT~~~~~~FFGGGPPPPPPPPPPPPPPG~~GFGGGGGGFGGGGGGTGGGGGGGGGTGGGGGGPFFFF~~~~~GGFGGPGGTTG
FPTGGGTTGGGGFGGGTGGGGTGGGT~~~G~GGGGGGGTGGTGTGGG~~~~~FFGGGTGFFGGGGGGGTTGPPGGGGGGGGG~GGTGGGGGGGGGGGGGGGGGG~~~PFFF~~~~~~~FFGGPGTGGG
FPGGGTGGGGGGGGGGGGGGGGGGFF~~~~~~GGGGGGGFGTGGGFG~~G~~FGGGGGGGGGGGGGGGTGGGPGGGGTGGG~~GGGGGGGGGGGTGGGGGGTTG~~~PFGTG~~~FFFFFGGPGGTGF
FPGGGTGGGGGGGGGGTGGGGGGGFF~~~~~~GGTTGTGFGGGGGFGGG~~~FGGGGGGFTGGGGGGTGGGGPGGGGGGGG~~GGGGTT~TGGTGGGGTGTGTGG~~PGGGTGGGFFFFFGGPTGGFF
FPGGGGGGTGGGGGGGGGGGGGGTFF~~~~GGGFFGFTGGGGGGGFGGGG~~FGGGGTTFFFFTGGGGTTGGPPGGGGGGGG~GTGGGG~~~GGGGGGGGGGGGTDPPGGGGGGFFFFFFFGPFFFFF
FPPPGGGGFFGGGGGGGGGGTG~FFFF~~~~GGFTGFFGTGGGTGGGGGGGGFGGGGGFFFFFFGGFFTGGGGPPPPPPPPPPPPPPPPPPPPPPPPPPPPJPGGGGGGGGGGGFFFFFFFFPGFFFF
FPGPGTGFFFFTGGGGGGTG~~~~~FFG~GTGGFFFFFGTGGGGGGGGTGGGTGGGFFFFFFFFFFFFGGGGGGGGT~~~~~~GGGGGGGTGHGGGGGTGGPPPGGGTGGGGGFFFFFFFF~PGFFFF
FPGPGGTFFFFTGGGGGGG~~~~~GFGGGGGGGFFFGGGGGGGGTGGTTGGGGFGFFFFFFFFFFFFFTGGGGG~~~~~~~~GTTGGGGFGGGGGGGGGGGPGPGGGGTGTGGGGFFFFFF~PGFFFF
TPGPTFGFFGGGGGGGGTGT~~~~TGGGGGFGGGFFGGGTGGTGTGGTGTGGTFFFFFFFGTGFFFFFGGGGGGGGG~~~~GFFFGFFFFFGGGGGTGGGGPGPPGGGGGTGTGTGFFFFF~PGFFFF
GPGPGFFFFFGGGGGGGGGGG~~~GGGGGGGG~~~TGGGGGGGGGTGGGGGGGGFFFFFFGGGFFFGTGGGGGGGTGG~~~~FFFFFFFFFTGTGGGGGGGPGGPPGGGGG~~TTGGFGGGGPFFFFF
GPGPFFFFFFGGGGGGGGTGG~~~GGGGGGG~~~~~GGGGGGGGGGFGTTGGGGFFFFFGGGGGFFGGGGGGGGGTGGGG~FFFFFFFFFFFGGGGGGGGGPGGGPGGGGGG~GGGGGGGGGPFFFFF
GPGPPFGGFFGGGGGGGGGGGG~~GGGGGGGGG~~~GGGGGGGGGFFFGGGGGGFFFFGGTGTGGTGTGGGGTGGGGGGG~FFFFFFFFFFGGGGGGGGGGPTGGPPPPPPPPGGGGTGGGGPFFFFT
TPTGPPPGFGGGGGGGGGGGGT~GGGGGGGGG~~~~GGGGGGGTGFFFGGGGGFFFFFGGGGTGGGGGGGTGGGGGTGGGFFFFFFFFFFFGGGGGGGGGGPGGGGGGGGTGPPGGGGGGTGPGTGFG
GPPGGGPPPPPPPPPPPPPPPG~GGGGGGGGGGGG~~GGGGGGTGGFF~~GGGGFFFGGGGGTGGGFFGGGGGGGGGGGFFFFFFFFFFGGGGGGTTGGGTPGGTGGGGGGGGPPGGGGGGGPTGGGG
GGPPPTGGTGGGGFFFFFGGPFFFGGFFFFGG~G~~~~GTTGGTGGG~~~~GGTFFFFFGFFFGGFFFGGGGGGGGGGGGFFFFFFFFFFGGGGGGGGGGGPGGGGGGGGGGGGPGGGGGGTPGGGGG
GGGGPPPPGTGGGFFFFFFGPFFTGGFFFFG~~~~~~FGGGGFFFGGGT~~GGGGFFGFGFFFFGFFFFTGGGGGGTGGFFFFFFFFFFFGGFFGGGGTGGPGTTGGTGGTGTGPPTGGGGGPGGGGG
GGGTGGTPPGGGGGGFFFFTPFFGFTFFFFGT~~~~FFGGGGFFTGTGG~GGFGGGFGFGFFFFFFFFFGFFFFGGTTTGFFFFFFFGFFFGFFFGGG~~GPGGGGGGGTGGGGTPPPPPPTPGGGGG
G~GGGGTTPPGTGGGFFFGTPFFFFFGGGGG~~~~FFGGGGGFGGGGGGGGFFFGGGGFFFFFFFFTFFGFFTTTGGTGGGG~FFFGGFFFFFFFFT~~~GPGGGGTGGGGGTG~~~~~~PPPGGGGG
GGGGGGGGGPPPGGGFFGGTPFFFFGGGGTGGGG~FFFFFFFFGGGFFFFFFFGGFFFGGFFFFFFFFFFFFFFGGGGGG~G~~~GGGFFFFFFFFFGG~GPGGGGGGGGGTGG~~~~~~PGGGGGGT
GGTGGGGGFFFPPGGGGGFFPFFGGTGGGGGGGGFFFFFFFFFGGGGFFFFFFFGFFTTFFFFFFFFFFFFFFFFGGGGT~~~~~~GGFGFFFFFFGGTGGPGGGGGGGGGGG~~~~~~~PFGGGFGG
TGGTGFFGTFFFPGGGGFFFPGGGGGGGGGGGGGFFFFFFFFFFG~~~FFFFFFGGGGGFFFFFFGFFFFFFFFGGG~~~~~~~~GGGGGGFFFFGGGGGFPTGGGGGG~GTTGFFF~~~PFGGFFFF
TFGGFFFFFFFFPFGFFFFFPGTG~GTGGGGGGGGFFFFFFFFGGG~~FFFFFFFGGGGFFFGFGFFTFFFFGGGGGG~~~~~~~GGGGTTGFFGGGGFFFPGTGGGGG~GGTFFFFFFFPGGFFFFF
GFFGFFFFFFFFPFFFFFFFP~G~~~~~TGGGGGFFFFFFFFGFF~~~~FFFFFTGTGGFFFGFTGGGGGFGGGGGGG~~~~~~FFGFFGGGGFGGGFFFFPGGGGFG~~GTGGFFFFGFPTFFFFFF
FFFFFFFFDFFFPFFTG~FFP~~~~GGGGGGGGFFFFFFFFFFFFF~~~FFFFGGGGTGFFGGGGGGGGGGGGGGGGTG~G~~~FFFFFTGGGGGTGGGGFPGGGGFF~GGGGGGFFFGGPFFFFFFF
FFFFFFFFPFFFPFFF~~~~P~~~~GGGGGGGTFFFFF~~~FFFFFGGGGFFFFFGTTTGGTTTTGGGFGGTGGGGGTGGGG~GFFGFFFTGGGGGGGGGGPGGGGTFGGGGGGGFGGGGPGFFFFFG
FFFFGGFGPFFFPFFF~~~~PG~~GTGGGGTGGFFFFFG~~~GGGGGTGGGFGFFGGGGGGGGTGGGGGGGGGGGGGGGGGGGGGGFFTGGGGGGGGGGGGPGGGGGGGGGGGTFFGGGGPGGFFFFF
FGFGGFFGPGFGPFFF~~~~P~~GGGGGGTGGFFFFFF~~~~~GGGGGGGGTGFTGGGGGTGGGGGGTGGGGGGGGGGGTGTGTGGGGGFFFTGTGGGGGGPGGGGGGGGGGGGFFFGGGPGFFFFFF
GGGGGGFGPTFGPFFFF~~GPGTGGGGGGGGTFFFFFF~~~~~GTGGTGGGGGGTTGGTGGGGGGGGTTTGGGGGGGTGGGGGGGFGFFFFFFGTGGTGGGPGGGGGGGGGGGGFFFFGGPGGFFFFF
GGGGGGGGPGGGPFFFFFFGPGGGGGGGGG~~FFFFFF~~~~~~GGGGGGGTGGGGGGGGGGGGTGGGGGGGTGGGGGGGGTGFFFGFFFFFFFTGGTGFFPGGGGTGTGGGTFFFFFGGPGGGFFFF
TGGTPPPPPGGGPFFFFFGGPGGGGGGFFG~~~GFFF~~~~~~~GGGGGGGTGGGGGGGTGGGGGGTGGGGGTGGGGGGGTGGFFFFFFFFFFTGTFGFFFPGGTGGGGGGGGTFFGTGGP~GGTFFF
GGGGPGGGGGGGGGGGGGGGPGGGGGTGFF~~GTGF~~~~~~~GGGGGTGGGGGGTTGGGGGGGGGGGGGGGGGGGGGGGGGGGFGGFTFFFFGGGFFFFFPGGGTGGGGGGGTGGGGGGP~G~GGFG
GGGGPGGGGGGGGGGGGGGGPTGTGGTFFFGGTGG~~~~~~~~GGGGGGGGGGGGGTGGGGGTGGGGGGGGGGGGGGGGGGFFGFGGGGTGFGGGGFFFFFPTGGGTGFFFGTGGTGGGGP~~~~GGG
GGGTPGGGGGGGGGGGGGGGPGGTGGGFFFFGGTG~~~~~~~GGTGGGGGGGGGTGGFFGGGGGTGGGGGGGGTGGGGGGGGFFGGGGGTGGGGGTGFFFFPGGGGGGFFFFGGGGGGGGP~~~GGGG
GGGTPGGGGGGGGGGGGGGGPGGGGGGFFFFFGGG~~~~~~~GGGGTGTTGFGGGGGFFFFGGGGGGTGGGTGGGTGGTFFFFFTTGFFGGGGGGGTFFFFPGGTGGFFFFFTGGGGGTGP~~~~GFG
GGGGPGGGGGGGGGGGGGGGPGGGGGGGGFFFFFGGG~~GT~G~TG~GGGFFFGGGGFFFFTGTGGGFFGGGGGGGTGGFFFFFFGFFFGGGGGGGGFFFFPGTGGGFTGFGTGGGGTGGP~~GGGFF
GTGGPGGGGGGGGGGGGGGGPGGGGGGGFFFGGGGGTTGG~~G~~~~GGTTFFFGGFFFFFFGGGTGFFFG~~~GGGTGTGFFFFFFFFGGGGGGGGFFFFPGGGGGGGGGGGGGGGGGTP~~~FFFG
GGGGPGGGGGGGGGGGGGGGPGGGGGGGGFFTGGGGGGGGGTGT~~~~~GGFFFTGFFFFGFGGGGGGGF~~~~GGGTGGFFFFFFFFFFGGTGGGTTFFFPGGGGGGGGGFFTGGGGGGPFFFFFFF
GGTGPGGGGGGGSGGGGGGGPTGGTGGGGGGGTGGTGGGGGGTG~~~~~~~F~GTGGGGGTFGTGGGGTGT~~~GGGGGFFFFFFFFGTGTGGGTGTGGFGPGGGGGGGGFFFGGGGGGGPFFFFGFF
TGGGPGGGGGGGGGGGGGGGPGGGGGGGGGGGGGGGGGGGGGTGG~~~~~~~~GGGGGGGGF~~~GGGGG~~~~TGGGGGFFFFFFFGGGGGGGGGGGGTGPTGGGGGGGFFFGGTTGGGPFFFFFFT
TGGGPGGGGGGGGGGGGGGGPTGGTGGGGGTGTGGGGGGGGGTGG~~~~TG~~GGGGGTGGG~~~GGGGGTG~GGGTGGGFFTGFFFFTTGGGGGGGGTGGPGGGGGGGGFFFGGTGTGGPFFFFFGG
GGGGPGGGGGGGGGGGGGGGPGGGGGTGGGGGGGGGGGGTGGTTGG~~~~~~~GGGGGGGG~~~~~GGGTGGGG~GGTGGGGGFFFFFGGGGGGGGGGGGTPGGGTGTGGFFF~~GGGGGPFFFFFGG
GGGTPGGGGGGGGGGGGGGGPTGGGGTGGGGGGGGTGTGGGTTTG~~~~G~G~GGGGGGGGTGG~GTGGGGGGG~~~TGGGTFFFFFFFFGGGGGGGGGGGPGGGGGTGGGG~~~~GFFGPGFGFFGG
GGGGPGGGGGGGGGGGGGGGPHGGGGGGGGGGGGGGGTGGGGFFTFFFGGGGGGGGGGGGGGGGGTGGGTGGG~~~~GGGGTFFFFFFFFGG~GGGGGGGFPGGTGTGGGTG~~~~GFFGPGFGTGGG
GTGGPGGGGGGGGGGGGGGGPGTGGGTGGGTGGGGGGGGGFFFFFFFFFGGGGTGGTGGGGFGFFGGGGGGGGG~GTGGGGTFFFFFFFFFF~~~GFFFFFPFGGGGGGFGGG~GGFFGGPGGGGFTF
TTGGPGGGGGGGGGGGGGGGPGGGGGTGGGFF~~GGGGFFFFFFFFFFFGGGGGGGGGGGGFFFFGGGGGGGT~~~T~GG~GTFFFFFFFFGG~~~~FFFFPFFGGFGGGGGGGGFFGGGPGTGFFFF
TGTGPPPPPPPPPPPPPPPPPGGGGTGGGGGG~~~~GGFFFFFFFFFFFGGTGGTTGTGGGFGFFGTGGGGGGGGTG~~~~GTFFFFFFFGG~~~~~FFFFPFFGGFGGGGGTGGGGGGGPGG~FFFF
GGGTGTGGGGGTGGGGGGGGGGTGGGGGGGTGG~~~~GGFFFF~~FFFTTTGGGTGGFFFGGGG~~TGGGGGGGGG~~~~~TFFFFFFFFTG~~~~~FFFFPGGFFFFFFGGGGTGGGGGPG~~~FFF
GGGGTGGGGG~~~GGGGGGGGGTGGGTGTGGTGG~~GGGGFFF~TGGTGGGGGGGTGFFFGGG~~~~GTGFFFFGG~~~~~TGFFFFFGGGTT~~FFFFFFPFFFFFFFGGGGGGGGGGGPGG~GGFG
GGGGGGGGTG~~~~GGGGGGGTGGGGGGGGGTG~~GGGGGFFG~~GGGTGGGGGGGGGTGGGGG~GGGGGFGGFGG~~~~~~GGGGGFGGGGGGGFFFFFFPGFFFFFFGGGGGGGGGGTPGGGGGGG
GFFFTGGGGGG~~~GGGGGGGGGGGGGGGTGGGG~GTGGGGG~~~GGGGGTGGGGGGGT~~~~~~GGGGGGGGGTT~~~~~~GTGGGGGGGGGGGGTFFFFPGFFFFFFTGGGGGGGGGGPGGGGGTG
FFFFGGGGG~~~~~GGGGGGGGGGGGGGGGTGGGGGGTGGG~~~~GGGGGGGGGTGGGG~~~~~~GGGGGGGGGGGG~~~~GGGGGGGTGGGGTPPPPPPPPGGFFFFFGG~GGGTTGGGPGGGGGGF
FFFGGGGGG~~~~~GFGFFGGGGGGGTGGGGGGGGGGGGG~~~~~GG~~GGTGGGFTGGG~~~~GGGGGGGGGGGTTGF~~TGGGPPPPPPPPPPGGTGGGGGTGGFT~~~~~~TTGGTGPGGGGGGF
GFGGG~FGGG~~~GGFFFFFGGGGGGGGGG~GGGGGGGGGG~F~~GGTGGGGGGFFGFG~~~~~GGGGGGGGGGFGGTFFFFGTPPGGFFFFFFFGGTGTGGGGGGGG~~~~~~GGGGGGPGGGGGFF
GGGGG~FFFG~TGTFFFFFFGGGGTTG~~~~~TGGGFGGGGFFFFGTTGGG~GFFFFFFG~~~~GGGGTGTGGGFGGFFFFPPPPGGGGFFFFFFFGGTGGGGGGGGFGG~~~~~GGGGGPGGGGGFF
GGGT~~FFFFGGTGG~G~F~GTGGGGT~~~~GG~GFFGFFFFFFFFGGGGG~GGFFFFFFG~FFGGFFFFGTGFFFGFFFFPGGGGGGFFFFFFFFFGGGGGGGGGGFGG~G~~~GTGGGPGGGGGGT
GGGGGGFFFFFFGTG~~~~~~TTGFFGG~~~~~~GFFTGFFFFFFGTGGTTGGTGFFFFFFGFFFTGFFGGGGGFFFFFFFPTTGGGTFFGFFFFFGGGGGGGGGTFFFGGGGGGGGTGGPGTGFGTG
GGGGGGFFFFFFGG~~~~~~~~TGFFGG~~~~~GGFFGGGFFFFFGGGGGTGGGGTFFFFGTFFGTFFTGTGFFFFFFFFFPGGGG~TTGGFFFFFFGGGGTFGGTGGFGGGGTGGGGGGPGGGFGGG
GGGTGFFFFFFGG~~~~~~~~~GGGTGG~~~~~~T~FFFGFFFFFGGGGGGTGGGGGTFGGTGGGTGGGGGGFFFFFFGFFPGG~~~~~~TFFFFFFGGGGFFGGGGGGGGGGGFGGGGGPGFFFFGG
GGFFGGGGFGFGGG~~~~~~GGGGGGGGGGT~T~~FFFFFGFFFFFTGTGTFTGGGGFFGGGGGFFTGGGGGGFFFFTGGFP~~~~~~~~GGFFFFFGGFFFFGGGGTGGGGGGFGGGGGPTFFFGGG
GFFFFGGGGGGGGGG~~~~~GGTGGGGGGGGGGGGFFFFTFFFFFGGGGTFFFFFGFGGGTGTFFFTTTGFTGFFFFFGPPPG~~~~~~GGGGGFGTGGGFFFTGGGTGTGGGFFFGGGGPGFFFFGG
FGFFFF~GGGTTGGGGGGGGGGGGGGTGTGGGGGGTGGFGGFFFFFGGGGFFFFFFFFFGGGGFFGGFFFFFGGGGGGGGGGGGGGG~~GGTGGGTGGGGFFTGGGGGG~~~FFFFFG~GPPPPFGTG
FGGFF~~GTGGGGGGGGGG~GGGGGGG~GGTGGGGGGGFGTGFFFGGGGFFFFFFFFFFGGGG~GGGFFFFFGGGGGGGGGGGGGGGG~GGGGGGGGTGFFFGGGGGGG~~FFFFFFGGGGGFPGGGF
FFFFF~~~GGGGGGGGG~~~~~GGG~~~~~GGGGTTGGGGGGGGGTGGGFFFFFFFFFGGGGG~GGGFFFFFGGGGGGGGGGGGGGGGGGGGGGTGGGGGFGGGGGGGG~~FFF~FGGGGTGFPGFFF
FFFF~~~~~GGGGTGT~~~~~GGGTGG~~~GTTTGGGGTGGTTTT~~~GGTFFGGTGFFGGG~~GGGFFFFFGGGGGGGGGGGGGGGGGGGGGGGGGTGGFGGGT~~~~~~FF~~GGGTGGGFPFFFF
FFFFG~~~GGTGGG~GG~~~~GGGGG~~~~GGTGGGGGGGGGGGTTGGGGTFFFGGT~GGTGG~GTGGFFGFGGGGGGGGGGGGGGGGGGTGGGGGGGGGGGTGG~~~~~FF~~~~~GGGGFFPFFFF
FFFTG~~~~~~TGGTGGTG~~GGGGG~~~GGGGTGGGFFFFTGGGGGGGTGFFFGF~~~~GGG~GGGGGGGGGGGGGGGGGGGGGGGGGGGGGFFGGGGGGGTTGGTG~FFFF~~~GGGGGGFPFFFF
FFFGG~FFGGGGTGGGGGGT~GGGGTT~TGGGGTGGTFFFGGFFFGGGGGTFFFFFF~FGGGGGGGGGTGGGGGGGGGGGGGGGGGGGGGGGGGGGGGGGCGGGGGGGGFFF~~~~GGGGGGGPFFFF
FFGGGGFFFFGGGGGGGGGGFGGGTGFFFGGTTGGGFFGFGGTFFGGGGFGFFFFFFFFG~TFGTGTGGGGGGGGGGGGSGGGGGGGGGGGTGGGGGTGCCCTGGGTGTGFFFT~TGGGGTGGPFFFF
FFFGGFFFGTGGGGGGGGGFFFGGTFFFGGGGGTGGTGGGGGGFFFFFGFFFFFFFFFF~~~FFFFTGGTGGGGGGGGGGGGGGGGGGTGGGGTTTGTCCCCCGGGGGGGGGGGGGGGGGTGTPFFFF
FFFFFFFFFGGGGGFFGTGFTGGGFFFFFGTGGGGGGGGGTGTFFGGGFFFFFFFFFFFFTTFTFGFGGGTGGGGGGGGGGGGGGGGGGTGGGGGGGTG~CCGGTGGTGGGGGGGGGGGGGGGPFGGG
FFFFFFFFFFGGTGFFFFGGGGTGGFGFGGGGTGGGGGGGGGGGFGFFFFFFFFFFFFFFGGFFFFFTGGGGGGGGGGGGGGGGGGGGFGGGGGGGGGG~CGTGGGGGGGGGTGGGGTGGGGTPGGGG
FF~FGFFGGFFGGGFFFFFGGGGTGGTFGTGGGGGGGGGGGGGGGGTGGFFFFFFFFFGGTFFFFFFFGGGGGGGGGGGGGGGGGGGGFFFGGGGGGT~~~GGTGGGGG~GGGTGGGGGTGGGPGGGT
F~~~~FFFFFFFFGFFFFFGGGTGTGFFFGGGGGGGTGGGGGGGGGGGGGFFFFFFFFGGGTFFFFFFFGTGGGGGGGGGGGGGGGGFFFGGGTGGGG~~~~TGGGGGG~GTGGTGGTGGGGGPTTGG
~~~~~~FFFFFFFFFFFGGGGGGGGGGTGGGGGGGGGGGFFFGGGGTGGTGFFFFFFFFGGGFFFGFGGGGGGGGGGGGGGGGGGGGFFFGTGGGGGT~~~~GGTGGGG~TTGTGGGGGGGGFPGGTG
G~T~~~FFFFFFFGGFGTGGGGTTGGGGTGGTGGGGGGGFFFFFFTFGTGGFFFFFFFFGGGGGGGTGGGGGGGGGGGGGGGGGGGGGGGGGGGGGGGG~~~GGGGGG~~~TGGGGGTGGTFFPPPGG
GGG~GGFGFFFFFGGFTGTGFFGGGGGGGGTGGGGGGGGFFFFFFFFFTTGGFFFGGGGTGTGGTGTTGGFFFF~~~GFFFFFFFFGGGGGTGGGGGGGGG~TGGGTG~~GGGTGGGGGGFFFPGPGG
GTGGGGGGGFFGGTGGGGGGFFFGGGGGGGGGGGGGGGTGFFFFFFFFF~~GFF~~TGGGGTGGGGTGGGFFFFFGGGFFFFFFFTGGTGGGGGGGGGGGGGGGGGGGGGGGTGGGGGTGGFFPGPGG
GGGGGGGGTGTGGGTGGGGFFFTGGGGGGGGGGTGGGGGGFFFFFFFF~~~~FFF~GGG~GGGGGGGGGGGGFFFGGGGFFFFFFFGGGGGGTGTGGGGTGGGTGGGFFTGGTGGTGTTGTGFPFPGT
GGGGTTGGTGGGGGTTGTTFFFGGGGGGGGGGGTGGGGGFFFFFFFFFFFFFFF~~~GT~GG~FFTTGGGGGGGTGGGGGFFFFFFGGGGGGGGGGTGTGGTGGTGGGGGTGGGT~GGGGGGFPFPGT
GGTGGTGGTTGTGGTTGTGGGGGGGGGGGGGGGGGGGGGTFGFFFFFFFFGFGF~~~~~~~~~FFGGGGGGGGGGGT~~~GFFFFFFGGGGGTGGGGFFFTGGGGTGGGGGGGGG~GGGGGGGPFPFF
GGGGGGGGGGGGGGGGGGGGGGGGGGGGGGGGGGGTTGGGGGGFGFFFGGGTGG~~~~~~FFFFFGGGGGGGGGGGGG~~~FFFFFGGGGGGGGGGGGFFFF~~~~GGGGGGTGGGGGGGGGGPFPFF
GGGGGGGGG~TTGGGGGGGGGGGGGGGGGGGGGGGGGGTGGTTGGT~GFTGGGGG~G~~~~FFFFGGGGGTGGGGTGGG~FFFFFFTGTGTFGGGTTFFFFG~~~GTGGGTTGGGGGGGGGGGPFPFF
GGTGTGTT~~~GGGTGGGTGGGGGGGGGGGGGGGGGGTGGGGGGG~~~~~GGGGGGGG~~~FF~~GGGGGGTGGGGGGTGFGFFFGGGGGFFFFGGGFFFF~~~~~TGGTGGTGGGGGGGGTGPGPFF
GGGGGGGG~~~~GFTGTGTGGGGGGGGGGGGGGGGTGGTTGGGGGG~~~~GGGGGGGG~FF~~~~~GGGTTGGGGGGTGGGGFGGGGGGGFFFGTGFFFFF~~~~~~TTFGFFGGTGGGGTGGPGPGG
GGG~~GFF~~~GGFGGTGTGGGGGGGGGGGGGGGGGGGGGGGTG~~~~~~~TTGGGGGFFFG~~~~GGGGTGGTGFGGGGTGGGGGGTGGGFGGGGFFFFFFGG~~GGFFFFFGGGFGFGGGGPTPGG
GTGG~~FFF~FFFFFGGGTGGGGGGGGGGGGGGGG~GGTGGGGT~~~~~~~GGGGGGTTFFG~G~~~GGTGGGGGFTGGGGFGG~GGGGGGFFFFTGFFFGGGG~~GGGFGFFTGGFFFFTGGPGPGG
GFFGGGFGFFFFFFGGGGGPGGGGGGGSGGGGGGG~~GGTTGGG~G~~~~GG~~~GGGFFFGGGTTGGGGGGGGGGGGTTGFFFGTGGGGGFFFFFTGG~~GFNPPPPPPPPPPPPPPPPPPTPGDGF
FFFTGG~GGTFGFGGTGGGPGGGGGGGGGGGGGGG~~~TGGGGGGG~~~~GGG~~~FTFFFGGGGGGGGPPPPPPPPPPPPPFFGGTGGGFFFFFFFF~~~GFFFFG~~~~~GGGTGFGFGPGPGGTG
FFFFG~~GGGGGFTGGGGGPGGGGGGGGGGGGGGG~~~~GGGGGGG~~~~GG~~~FFGFFFFGGGTGFTPGGGGGGTGGGGPFFFFFGGGGGGFFFFFFGGFFFFFG~~~~~~GGTGGGFGPGPGGGG
FFFFF~~~~~GGGGGGGGGPGGGGGGGGGGGGGGG~~GGGGGTGGGG~GTGT~~FFFFFFFFTGGTFFGPGGGGGGFGTDGPFFFFFFFFGGGFFFFFFGTFFFFFFF~~~GTGGGGGGFGPGPGGGG
FFFFFG~~~~~GGGGGGGGPGGGGGGGGGGGGGGG~GGGGGTGGTGGGTGG~~~~FFFFFFFFGGGFFFPGTTGGFFGGPGPPFFFFFFFFGGGGFFFGG~~FFFFGT~~~GGGGTTGFFFPGPTGTG
GG~FGG~~~~GTTTGGTPPPGGGGGGGGGGGGGGGGGTGGGTTGGGGGGGGG~~~FFFFFFFFFGGFFFPGGGGGFFFGPTGPPFF~FFFGGGGGGGGGTG~FFTFGGG~GGGGGGTFFFTPGPGGGG
G~~GGGGTTGTG~~TGGPGGGGGGGGGGGGGGGGGGGGTGGGGGGGGGGG~~~~~~FFFFFFGGGGGFGPGGTGGGFFGPPGGPFF~FFFFFTGGGGGGGG~~FFGGGGGGGTGGFFFFFFPGPFFGG
G~~FFGGTGGG~G~~GGPGGGGGGGGGGGGGGGGGTGGGGTTGTTGGGGG~~~~~GGGFFFFFGTGGGGPTGGGGGGT~~PPGPF~~~FFFFFTGGGGGGG~GTGGGGGTGGGGGTFFFFGPGPFFFG
GFFFGGGGGG~~~~~~~PFFGGGFFGGGTGGGGTGGGGGFFFFGGGGGTG~~~~~GGGFFFFTGTGGTTPGGTGGTG~~~~PGPPG~~~FFFFFGGGGGGGGGGGGGGGGGGGGFFFFFGGPGPFFFF
TFFFGTGFTGG~~~~G~PFGGGFFFTGGGGGTFTGGGGGFFFFGGGGGG~~~~~~TGFFGFGGGTGGGGPFFGGGG~~~~~PGGPPPPPFFFFFGGGGGGGGGGGGGGGGGGGGGTGGTGGPGPFFFF
GGGGGGFFGGGG~~GG~PGGGTFFFFGTGGGGTGGGGGTFFFFTGGGDPPPPP~GGGFGGGGGGGGGFFPGFTTGG~~~~~PPGGGGGPPPPPPPPPPPPPPPPGGTGGGGGGGTTGGGGGPGPFFFF
GG~~~~FFFGGT~GGGGPGGGTFFFFFGGGGTTGTGGGGFFFFGGGGGGGGGP~GGGGGGGTGGGGFFFPGGGGGGG~~~~TPPPPPGGGGGTGTGGFFFFFFPGGGGGGGGGGGGGTGGFPGPFFGT
G~~~~TFFGGGG~GTGPPGGGGFFFFFFTGGGGGTGGGGGFGGGGGGGGTGGPGGGGGGGGGGGGFFFFPTGGGGTGGGGTGGGFFPPPPPPPPP~G~FFFFFPGGGGGGGGTGGGGGFGFPGPGGGG
G~~~~~GGGGGGGGGPPGGGGFFFFFFFGGGG~GTGGGGTGTGGGGGGFTGGPPPPPPPPPPTGGFFFFDGGFFFGGGTGGGGFFFFPFFFFFFP~~~FFFGFPFGGGGGGGGGGGGGFFFPGPGGGG
~~~~~~GGGGGTGTGPTGG~GGFFFFFGGTG~~GGGGGGGGGGGGGGGFGGGGGGGFFFFGPPPGFFFFFFGFFFFFGGGTGFFFFGPFFFFFFP~~~~GGGGPFGGGGGGTGGGGGFFFFPGPHGGG
~~~~~TTFGFFGGGPPGG~~G~FFTTGGTG~~~~~G~GGGGGGTGGGGGGGGGGGTGFFFGFFPPPPPPPPPPPPPPPPPPPPPPPPPF~FFFFP~~~~~GGGPFFGGGGGGGGGGGGFFFPGPGGGG
~~~~GCGFFFFGGPPTT~~~~~~~GGGGG~~~~~~~~~TGGGGTGGGGGGGGGGGGTGTDTFFFGGGGGGGGGGGTFFFFFFGGFFFF~~~FFFPPG~GGGGGPGGGGGTGGGTGGGGTTFPTPGGGG
~~GGCCCFFFPPPPGGGG~~~~~~TGGGG~~G~~~~~~GPPPPPPPPPPPPPPPPPPPPPGGFFFGGGGGGGGGGTTGGFFFGGFFFF~~~~~~GPPPPGGGGPGGTGGGTGGGGGTGGGTPTPGGGG
GMHCCCCCFFPGGGGTG~~~GGTGGGGGGGTG~~~~~~TPGTGGGGGGGGGGTGGGGGGGGGGGGTGTGTTGGGGGGGGGFGGFFFF~~~~~~~GGGGPGGGGPGGGGGGGGGGGGGGGGGPGPGGMG
JPPPPPPPPPPPPPPPPPPPPPPPPPPPPPPPPPPPPPPPPPPPPPPPPPPPPPPPPPPPPPPPPPPPPPPPPPPPPPPPPPPPPPPPPPPPPPPPPPPPPPPPPPPPPPPPPPPPPPPPPPPPPPPJ
