JPPPPCCCTFFFFFFFFFGGFFFFFFFGGGGGGGGGGGFFFFFFGTGTGGGGGGGGGGTGGTGT
PPPPPCCTFFFFFFFFFFFGFFFFFFFGGGGGGGGGGFFFFFFFGGTGGGGGGGGTTGGGGGGG
PPPPPCFFGFFFGFFFFGGGGFGFFFFFGGFTGGGGFFFFFFFFGGGGGGGGGGGGGGTTGTTG
PPPPPFFFFFFGTGFTTGGGGGGGFTGFGFFFTGGGGFFFFFFFFGGGGTGGGGGGGGGGGGGG
PPPPPGGFGTGGGGGGTGGTGTGGGGGGGFFFTGGGGGFFFFFFFFGTGGGGGGTGGGGGGGGG
PPPPPGGGGTTGGGTGTGGGGGGGGGGTGGFFTTGGGTFFFFFFFGGGGTTGGGGTGGGGGGGG
PPPPPGTTGGGGTGGGGTGTTGGGGGGGGFFFFGGGGGFGGGFFFFGGGGTTTGGGGGTGGGGG
PPPPPGGGGGGTTGGGGGGGGGGTGGGGTFFFGGGGGGGGGGTFFFFFGGGGTGGGGG~~~FGG
PPPPPPGGGGGGGGGG~~~GTGGGGTGTGTFTGTGGGTGGGGTFFFFFGGGGTGGTG~~~FFFF
PPPPPPGGGTGTGTTGGGGGGGGGGGTGGGGGTGGGGGGGTTGGGGGGGGGGGGGGGG~~~FGT
GPPPPPPGGGGTGGTGGGGTGGGGGTGGTGGGGGGGTG~TTGTGTGGGTGGGGGTGG~~~FFFG
GGPPPPPPTGTTGTGGGGGTGGGGGGGTGGGGTGGGGG~~G~~GGGGGGGTTGGGGGT~~~FFG
~GPPPPPPPPPGGTGGGGGGGGGGGGGGG~~GFFFFF~~~~~~~~GGGGTTTGTGGG~~~GFTG
~~~~PPPPPPPPGGGGGGGGGGGGGGGGG~~FFFFFFG~~~~~~GGF~~~GTGTGGGGTTFFFG
~~~~~PPPPPPPPPGGGGGGGGGGGGGGG~~~FFFFFGG~~~~~GFF~~~GTGGGGGGGGFFFG
~~~~~PPPPPPPPPGGGGGGGGGGGGGGG~~~~FFFFGGGG~G~GFFF~~GGGGGTGGGGGFGG
G~PPPPPPGPPPPPGGGGGGGGGGGGGGG~~GGTGFGGGGGGGGFFFFFGGGGTGGTGGTGGTT
GGPDPPPPPGGPPPGGGGGGGGGGGGGGGGTGGG~~~~GGTGGTGFFFGGGGGGGTGGGGGGGG
GGPPPPPPPPTPPPGGGGGGGGGGGGGGGGGGGG~~~~~GTGGGTGGGGGGTGTGGGG~~GGGG
GGPPPPPPPPPPPPGGGGGGGSGGGGGGGTGGGG~~~~~G~~GG~TGGTGGGGGGGGG~~~~GG
PPPPPGPPPPPPPPGGGGGGGGGGGGGGGGGGGG~~~~~~~~~~~~GGGTGTGGGGGGG~~~GG
PPPPPGGPPPPPPGGGGGGGGGGGGGGGGGGGGT~~~~~~~~~~~~FGTGGGGGGGTGG~GGTG
PPPPPGGPPPPPPGGGGGGGGGGGGGGGG~~GGG~~~~~~~~~~~FFFGGGGGTG~TGGGGGGG
PPPPPPPPPPPPPGGGGGGGGGGGGGGGG~~GTG~~~~~~G~~~~FFFGGGTGGT~GGGGGGTG
TPPPPPPPPPPPPGGGGGGGGGGGGGGGG~~GGGTFF~FFGGFFFFFFGGGGGGT~TGGGGGGG
GPPPPPPPPPPPPMGGGGGGGGGGGGGGG~~~GGFFFFFFFGGFFFFFFFGTG~~~GGGGGGGG
GPPPTGGGTGPPPGGGGGGGGGGGGGGGG~~~~GFFFFFFFGTGFFFFGTGTGGGTTTGGGTGG
TPPP~GGGFFPPPT~~~~GFFFFFFTGTT~~~GTFFFFF~GGGFFFGGGGGGGGGGGGGGGGGT
GPPP~~G~~FPPP~~~~~TGFFFFFGGG~~~~GGGFFFF~TGFFFFGGGGGGGGGGGGGGGGGG
HPPP~~~~~FPPP~~G~~FFFFFFFFG~~~~TGGGGTFF~~GGFFFGGGGGGGGGGGGGGGGTG
GPPP~~~~~~PPPGGGGGFGGGGGGGGGGGGGGGTGGT~~~~GGFFGGGGGGGGGGGGGGGGGG
GPPP~~~~G~PPPTGTTGGGGGGGGGGGGGGGGGGTGG~~~~~GGGGGGGGGGGGGGGGGGTTG
GPPP~TGGGGPPPGGGGTGGGGGGGGGGGGGGGGGGGG~~~~GTTGGGGGGGGGGGGGGGGGGG
TPPP~GTGTGPPPGGGTTGGGGGGGGGGGGGGGGGGGGG~~~GTGGGGGGGGGGGGGGGGGGGT
FPPPTGTGGGPPPPTGGTGGGGGGGGGGGGGGGGGTGGG~~~GGGGGGGGGGGSGGGGGGGGGG
GPPPFGGTGTPPPPPGGGGGGGGGGGGGGGGGGGFGGGG~~~~~TGGGGGGGGGGGGGGGGGGT
GPDPFGGFTGPPPPPPGGGGGGGGGGGGGGGGGGFFGG~~~~~GTTGGGGGGGGGGGGGGGGTG
GPPPFFFFTGGPPPPPPPPGGGGGGGSGGGGGGGFFGGG~~~~GGGGGGGGGGGGGGGGGGGTG
GTGGFT~~~GGGPPPPPPPGGGGGGGGGGGGGGGFFFF~~~G~GGGGGGGGGGGGGGGGGGGTG
GFFFFG~~~~GGGPPPPPPGGGGGGGGGGGGGGGFFFFF~~T~TGGGGGGGGGGGGGGGGGGGG
GFGGG~~~~GG~~~~GPPPGGGGGGGGGGGGGGGFFFFGTGTGTGGGGGGGGGGGGGGGGGGGG
GGGGGG~~~GG~~~~~GPPGGGGGGGGGGGGGGGFFFFFGGTGGGTGGGGGGGGGGGGGGGGGG
GTGGGGG~GG~~~~~~GPPGGGGGGGGGGGGGGGFFFFFFTTGTTGGTTGTGPPPGGGGGGGGG
GGFGTGGGGG~~~~~GGPPGGGGGGGGGGGGGGGGGFFFFFFGGGGTTGGGFPPPGGGGTGGTG
FFFFGTTGTT~~~T~GGPPGGGGGGGGGGGGGGGPPPPPPPPGTGGTT~~~FPPPGTTGGTTGT
FFFTGGGGTG~~GGGGGPPPPPPPPPPPPPPPPPPPPPPPPPGTGGGTG~FFPPPGGGTTGGTG
FFFFFGGGGTTGTGGGGPPPPPPPPGGGGGGGGGGGGGGGPPGG~GGG~~FFPPPGGGGTGGGG
FFFGGGGGGGGGGGGTGGGGGTTPPGGGGGGGGGGGGGGGPPT~~~~~~~~FPPPGGTTGGGGG
FFTGGGGGGTGGGGGGGG~GGGTPPGGGGGGGGGGGGGGGPPGG~~GG~~GFPPP~TGGGGTTG
GFGGGGGGGGGG~~~~~~~~TG~PPGGGGGGGGGGGGGGGPPG~~TFFFFGGPPP~~~GGTGGG
GGGGGGGGGTGG~~~~~~~~~~~PPGGGGGGGGGGGGGGGPPFFGFFFFGGGPPP~~~~TGGGG
GTGTGGTGGGGT~~~~~~~~GG~PPGGGGGGGGGGGGGGGPPFFFFFFFFGGPPP~~G~GGGTG
GTGGGGGTGTGG~~GG~~~~GGGPPGGGGGGGGGGGGGGGPPPFFFFFFFFPPPP~TGGGGGGG
GGTTGGTGGGGGG~GTGGGGGGGPPGGGGGGGSGGGGGGGPPPFFFFFFFFPPPP~GGGTGGTG
GGTGGGGGGTGGGGG~~~~GGTGPPGGGGGGGGGGGGGGGPPPFFFFFFGGPPPPGGGGGGGGG
GGGTTGGGGGGGGGGGGGGGFTGPPGGGGGGGGGGGGGGGPPGFFFFGGGGPPPGGFFGGGGGG
GGGGGTTGGGTGTGGGGGTFFTGPPGGGGGGGGGGGGGGGPPGTFFFGGGTPPPFFFFGGGGGG
TTGGGTGGTGGGGFFGGGGFFGGPPGGGGGGGGGGGGGGGPPGTTGTGGTTPPPFFFFFFGGGG
GGGGGGGGGGGTGGFFTTGTTTGPPGGGGGGGGGGGGGGGPPTGGTGG~~TPPPFFFFFFFGGT
GGGGGGGTGGGGGFFGGGGGGFFPPGGGGGGGGGGGGGGGPPTGGGGG~~PPPPFFFFFFFGGG
GGGGGGGGGGGGGGFGGGGFFFFPPGGGGGGGGGGGGGGGPPPPPPPPPPPPPP~FFFFFFFGT
GGGGGGGG~~~GFFFGGGGGFFFPPPPPPPPPPPPPPPPPJPPPPPPPPPPPPPGFFF~~FGGG
GGG~~~GG~~~~FFFFGGGTFFFPPPPPPPPPPPPPPPPPPPPPPPPPPPPPPMTGTC~~FFFF
GGG~~~GG~~~~FFFTGTGGFGFGGTGGTTGGGTGGFFFFFFFFTGGGGGTGTGGGCCC~CFFF
