##########
#..~~....#
#..~~..TT#
#....GG..#
##########
