~~~~~~~~~~~~~~~~~~~~~~~~~~~~~~~~~~~~~~~~~~~~~~~~~~~~~~~~~~~~~~~~~~~~
~~~~~~~~~~~~~~~~~~~~~~~~~~~~~~~~~~~~~~~~~~~~~~~~~~~~~~~~~~~~~~~~~~~~
~~~~BBBBBBBBBBBPPPPPPPPBB~~~~~~~~BBBBBBBBBBBBPPPPPPPPPPPPPPPPPPPPJ~~
~~~BCCCGGGGGGGGPPPPPPDPGTB~~~``~BFFGGGGGTTGGPPPPPPPPPPPPPPPPPPPPPP~~
~~BGGGGGGGGGGGGPPPGGGGGGGGBBB~~BFFGGGGTGGGGPPPPPGGGGGGPPPPPGTHCCCB~~
~~BGGGGGGGGGGGGPPPGGGGGGGGGGGBBFFFGGGTGTGGPPPPPPGGGGTPPPPPTGGGGCCB~~
~~BGGGGGGGGGGGGPPPGGGGGGGGGGGTGFFFGGGGGGGGPPPPPGGGGTPPPPPGGGGBGTCB~~
~~BGGGGGGGGGGGGPPPGGGGGGGGGGGGGGGGGTGGGGTGPPPPGTGGPPPPPPPBBBB~BBBB~~
~~BGGGGGGGGGGGGPPPGGGGGGGGGGGPPPPPPPPPPPPPPPPPPPPPPPPPPPB~~~~`~~~~~~
~~BGGGGSGGGGGGLPPPGGGGGSGGGGGPPPPPPPPPPPPPPPPPPPPPPPPPP~~````````~~~
~~BGGGGGGGGGGLLPPPGGGGGGGGGGGPPPPPPPPPPPPPPPPPPPPPPPPP~`````````~B~~
~~BGGGGGGGGGLLLPPPGGGGGGGGGGGGTGGPPPFFFFFFPPPGGGGGGPPP~```````~~BB~~
~~BGGGGGGGGGLLLPPPGGGGGGGGGGGGGGGPDPFFFFFFPPPTGGGGGPPP~~~~~~~~BBGB~~
~~BGGGGGGGGGLLLPPPGGGGGGGGGGGMGGGPPPGFFFGGPPPFGGTGGPPP~BBBBBBBGGTB~~
~~BGGGGGGGGGGL~PPPGGGGGGGGGGGPPPPPPPGFGGGGPPPFFFGGGPPPBGGGGTGGGGGB~~
~~BGGGPPPPPPPPPPPPPPPPPPPPPPPPPPPPPPGGGGGGPPPTGGFGGPPP~LTGGGFTGGGB~~
~~BGGGPPPPPPPPPPPPPPPPPPPPPPPPPPPPPPGGGTGGPPPFFFFFTPPP~LLTGGFFGGGB~~
~~BGGGPPPPPPPPPPPTGTTGGPPPPPPPPPPPPPPPPPPPPPPFFFFFFPPP~LLGGGFGGTGB~~
~~BGGGGGGGGGGGPPPTTGGGGPDPPPPPPPPPPPPPPPPPPPPGGFFFFPPPPPPPGGGGGGGB~~
~~BGGGGGGGGGGTPPPTTFTGGPPPPPPPPPPPPPPPPPPPPPPGGGFFFPPPPPDPTGGGGTGB~~
~~BGGGGGGGGGGGPPPFFFFFGPPPPPPPPPPPPPPPPPPPPPPTGGGFFPPPPPPPGGGGBBGB~~
~~BGGGGGGGGGGGPPPFFFFGPPPPPPPPPPPPPPPPPPPPPPGGGGGFTGLLLLLLLTGB~~BB~~
~~BGGGGGGGGGGGPPPFFFFPPPPPPPPPPPPPPPPPPPPPPPGGGGGGGGLLLLLLLTB~``~B~~
~~BGGGGGGGGGGGPPPFPPPPPPPPTFFFTGGGGLLGTGGGTGTTGGGGGGGLLLLLGGB~```~~~
~~~BGGGGGGGGGGPPPFPPPPPPPTFFFFTGGLLLLLTTTGGGTGGGGGGFFGLLLGGGB~```~~~
~~~BGGGGSGGGGGPPPFPPPPPPGGFFFFGLLLLLLLLGTGTGGGGTGFFFFFGLGGGTB~```~~~
~~~BGGGGGGGGGGPPPGPPPTGGGTFFFFLLLLLLLLLLGGTGGGTGGGGFGGGGGTGGB~```~~~
~~~BGGGGGGGGGGPPPGPPPGGGGGFFFLLLLL``LLLLTGTGGGGGGGTGGGGGTGGGB~```~~~
~~~BGGGGGGGGGGPPPPPPPTGTGGTGGLLLLL```LLLGGGGGGTGGGGTGGGGTTGGTB~~`~~~
~~~BGGGGGGGGGGPPPPPPPGTTTGGGGGLLLLL`LLLLGGGTTGGGGTGGTGGGTGTGGGBB~~~~
~~~BGGGGGGGGGGPPPPPPPGGGGGTGGGGLLLLLLLLLLLLGTGGGGGGTGGGGGGGGGGTGB~~~
~~BGGGGPPPPPPPPPPPPPPTGGGTGGGGGGTGLLLLLLLLLLGGGGGGGGGGGGGGGTTGGGB~~~
~~BGGFFPPPPPPPPPPPPPPTGGGGGGTGGGGGGLLGTLLLLLLGGGGGTGGGGGGGGTGGGGGB~~
~~BGFFFPPPPPPPPPPPPPPTGTTFFFFGTGFFGGGGGLLLLLLGGGTTGTGTGGGGGTTGTGGB~~
~~BGTFFFFFFFGTGPPPPPPGTTGFFGGTGTGFFFFGFLL`LLLGTTGGGTGGTGGGGGGGFGTB~~
~~BTTFFFFFGFGGGPPPPPPTGGGFFGGGGTGFFFTFFLLL`LLLGGGTGGGGTGTGGGGGFGGB~~
~~BTGGFFFFGGGGGPPPPPPGGGGFTGGGGGGGGFFFFLLLL`LLGGGGTTGGGGGGTGGFFFGB~~
~~BTGGTGGGTGGTGPPPPPPGGGGGGGGGGGGFFFFFFLLLLLLLGGGTTGLGGGGGGGFFGGGB~~
~~BGTGTGGGGGGGGPPPPPPGGGGGTGGGGTGGFFFFFGLLLLLLLGGGGLLLGGGGGGTFFTTB~~
~~BGGGTGGGTGLLLPPPPPPGGGGGGGGTTGGGFFFFFGGLLLLLLLTFLLLLLGTGGGGGTGGB~~
~~BGTGGGGGGLLLLPPPPPPTGTGTTGGGGGGGGFTTGGGGLLLLLLLFLLLLLLGGGGGGGTGB~~
~~BGGGGTGTGLLLLPPPPPPGGGGGGGGCGGGGGGGGGGGGTLLLLLFFLLLLLLGGGGGGGGGB~~
~~BGGGGGGGGLLLLPPPPPPTGGGGGGCCCGGGGGGGTGGGGGGLLGFFLL`LLLGGGGTGGGGB~~
~~BGGGGTGGGLLLLPPPPPPTGGGGGCCCCCGTGGGTGGGTGTGGGGGLL```LLGGGGGGTTGB~~
~~BGGGGGGGGTLLLPPPPPPGGGGTGGCCCGGTGGTGTGGGGGTGGTGLLL`LLLGGGGGGGTGB~~
~~BTGGGGGGGGGLLGPPPPPGGGGGGTGCGGGGGGGGGGGGGGTGTGGGLLLLLLGGGGGGTTGB~~
~~BGGGGGGGGGGGGGPPPPPFFFFGGGGGGTGGGGGGTTGGGGGGGGGGLLLLLLGGGGGGGGGB~~
~~BTGGGGGGGGGGGGPPPPPFFFFFGGGTGGTGGGGGLLTGTTGGGGGTLLLLLTGGTGGGGGGB~~
~~BGGGGGGGGGGGGGPPPPPFFFFFFGGGGGGFTGTLLLLGGGGGGGGGFLLLGGGGGTGGGGGB~~
~~BGGGGGGGGGGGGGPPPPPFFFFFFGLGGFGFFGLLLLLLGGGGGGFFFFGGGGGGGGGTGGGB~~
~~BGGGGGGGSGGGGGPPPPPFFFFFFLLLFFFFFLLLLLLLGGGGGGGFFGGGGGGGGGGGGGGB~~
~~BGGGGGGGGGGGGGPPPPPFFFFFLLLLLFFFGGLLLLLLGGGGGGGGFGTGTGGGGTGFGGGB~~
~~BGTGGGGGGGGGGGPPPPPFGFFFFLLLFFFGGTTLLLLGGGGGGGGGGGGGGTGGGGGFFGGB~~
~~BGGGGGGGGGGGGGPPPPPGGFFFFFLGGFGTGGGGTGTGGTGGGGGGGGTGTTGGGGGFFFTB~~
~~BGGGGGGGGGGGGGPPGGTGGFFFFFGTGGGGGGGGGTGGGGGGGGTGGGGTGGTGTGGFFFGB~~
~~BTBBBBBGGGGGGGPPGGGGGFFFFFGGGGGGGGGTGGGGTGGTGGTGGGGGGTGGGGGFFFGB~~
~~BB~~~~~PPPGGPPPPFFFFGGGFGGTGGGTGGTGGGTGGGGTTGFFFFGGGGGGGGGTFFFGB~~
~~B~````~PPPGGPPPPFFFGGGGGGGGGGGTGGGGGGGGGGGGTFFFFFGTGGGGGGGGGGGGB~~
~~~`````~PPPTGPPPGFFFGGGGGGGGGGGGGGTGTGGGGGGGFFFFGGGGTGGGGGGTGGTGB~~
~~B~````~PPPGHPPPFFTFTGGTGGGGGTGGGTGGGGGTGGGGGGGGGGTTTGTGTTGGTGGBB~~
~~B~````~PPPPPPPPFFGGTGGFGGTBBBBGGGGTGGGGGGTGGGGGGTTGGLTTGGTGGGB~~~~
~~B~````~PPPPPPJPFFFGFFFFGGB~~~~BBGTGTGGTGGTTGGGGGGGGLLLGGTGGTB~`~~~
~~~`````~PPPPPPPPGGGTTTFGGB~````~~BGGGGTTGTTGGTTTTGGGLLLGGGGTGB~`~~~
~~~`````~~BMGGGGGTGGGGGGGGTB~~~~``~BBBGGGGGGGGGGGGGGGGLGGGGGGGTB~~~~
~~~~~~~~BBGGGGTGGGGGGGGGTGTGBBBB~``~~~BGGGTTGGGTGGGGGGGTTGGGTGGTBB~~
~~BBBBBBBBBBBBBBBBBBBBBBBBBBBBBBB~~~~~~BBBBBBBBBBBBBBBBBBBBBBBBBBB~~
~~~~~~~~~~~~~~~~~~~~~~~~~~~~~~~~~~~~~~~~~~~~~~~~~~~~~~~~~~~~~~~~~~~~
~~~~~~~~~~~~~~~~~~~~~~~~~~~~~~~~~~~~~~~~~~~~~~~~~~~~~~~~~~~~~~~~~~~~
